Player,Season,Team,League,GP,G,A,PTS,PIM,+/-
Logan Cooley,2020-21,U.S. National Development Team,USHL,27,15,13,28,10,-1
Logan Cooley,2021-22,U.S. National Development Team,USHL,24,13,23,36,55,19
Logan Cooley,2022-23,U. of Minnesota,Big-10,39,22,38,60,42,38
Logan Cooley,2023-24,Arizona Coyotes,NHL,82,20,24,44,18,-13
Logan Cooley,2024-25,Utah Hockey Club*,NHL,50,15,28,43,24,4
Erik Cernak,2013-14,Kosice HC,Slovak,13,0,0,0,0,0
Erik Cernak,2013-14,Slovakia U20,Slovak,20,2,1,3,2,-7
Erik Cernak,2014-15,Kosice HC,Slovak,43,5,8,13,16,7
Erik Cernak,2015-16,Erie Otters,OHL,41,4,11,15,35,7
Erik Cernak,2016-17,Erie Otters üèÜ,OHL,50,3,18,21,53,31
Erik Cernak,2017-18,Syracuse Crunch,AHL,71,5,13,18,70,30
Erik Cernak,2018-19,Syracuse Crunch,AHL,9,2,5,7,14,-1
Erik Cernak,2018-19,Tampa Bay Lightning,NHL,58,5,11,16,58,25
Erik Cernak,2019-20,Tampa Bay Lightning üèÜ,NHL,67,5,7,12,59,11
Erik Cernak,2020-21,Tampa Bay Lightning üèÜ,NHL,46,5,13,18,38,8
Erik Cernak,2021-22,Tampa Bay Lightning,NHL,55,1,12,13,46,7
Erik Cernak,2022-23,Tampa Bay Lightning,NHL,70,2,14,16,53,8
Erik Cernak,2023-24,Tampa Bay Lightning,NHL,69,2,11,13,63,5
Erik Cernak,2024-25,Tampa Bay Lightning,NHL,49,2,13,15,29,20
Rasmus Dahlin,2015-16,Vastra Frolunda Jr.,Swe-Jr,1,0,0,0,0,0
Rasmus Dahlin,2016-17,Vastra Frolunda Jr.,Swe-Jr,24,9,13,22,74,18
Rasmus Dahlin,2016-17,Frolunda HC,SweHL,26,1,2,3,6,4
Rasmus Dahlin,2017-18,Vastra Frolunda Jr.,Swe-Jr,1,1,1,2,0,1
Rasmus Dahlin,2017-18,Frolunda HC,SweHL,41,7,13,20,20,4
Rasmus Dahlin,2018-19,Buffalo Sabres,NHL,82,9,35,44,34,-13
Rasmus Dahlin,2019-20,Buffalo Sabres,NHL,59,4,36,40,38,-7
Rasmus Dahlin,2020-21,Buffalo Sabres,NHL,56,5,18,23,26,-36
Rasmus Dahlin,2021-22,Buffalo Sabres,NHL,80,13,40,53,68,-22
Rasmus Dahlin,2022-23,Buffalo Sabres,NHL,78,15,58,73,92,12
Rasmus Dahlin,2023-24,Buffalo Sabres,NHL,81,20,39,59,66,-3
Rasmus Dahlin,2024-25,Buffalo Sabres,NHL,46,7,35,42,30,5
Matthew Highmore,2012-13,Saint John Sea Dogs,QMJHL,30,4,5,9,26,-3
Matthew Highmore,2013-14,Saint John Sea Dogs,QMJHL,68,19,31,50,62,-13
Matthew Highmore,2014-15,Saint John Sea Dogs,QMJHL,62,11,13,24,60,-1
Matthew Highmore,2015-16,Saint John Sea Dogs,QMJHL,65,22,53,75,38,25
Matthew Highmore,2016-17,Saint John Sea Dogs üèÜ,QMJHL,64,34,55,89,46,34
Matthew Highmore,2017-18,Rockford IceHogs,AHL,64,24,19,43,24,-6
Matthew Highmore,2017-18,Chicago Blackhawks,NHL,13,2,0,2,0,-4
Matthew Highmore,2018-19,Rockford IceHogs,AHL,12,3,6,9,6,1
Matthew Highmore,2019-20,Rockford IceHogs,AHL,21,4,8,12,14,5
Matthew Highmore,2019-20,Chicago Blackhawks,NHL,36,2,4,6,6,-1
Matthew Highmore,2020-21,Chicago Blackhawks,NHL,24,0,2,2,6,-5
Matthew Highmore,2020-21,Vancouver Canucks,NHL,18,3,2,5,2,0
Matthew Highmore,2021-22,Vancouver Canucks,NHL,46,5,7,12,14,1
Matthew Highmore,2022-23,St. Louis Blues,NHL,2,0,0,0,0,1
Matthew Highmore,2022-23,Springfield Thunderbirds,AHL,68,19,42,61,34,1
Matthew Highmore,2023-24,Ottawa Senators,NHL,7,0,2,2,0,
Matthew Highmore,2023-24,Belleville Senators,AHL,43,9,22,31,10,-8
Matthew Highmore,2024-25,Belleville Senators*,AHL,23,2,8,10,0,-4
Matthew Highmore,2024-25,Ottawa Senators,NHL,16,1,3,4,4,-2
Erik Brannstrom,2014-15,HV71 Jr.,Swe-Jr,1,0,0,0,2,1
Erik Brannstrom,2015-16,HV71 Jr.,Swe-Jr,41,8,22,30,26,-4
Erik Brannstrom,2015-16,HV71 Jonkoping,SweHL,3,0,0,0,0,-1
Erik Brannstrom,2016-17,HV71 Jr.,Swe-Jr,19,9,14,23,18,13
Erik Brannstrom,2016-17,HV71 Jonkoping,SweHL,35,1,5,6,2,10
Erik Brannstrom,2017-18,HV71 Jonkoping,SweHL,44,2,13,15,22,-3
Erik Brannstrom,2018-19,Chicago Wolves,AHL,41,7,21,28,36,1
Erik Brannstrom,2018-19,Belleville Senators,AHL,9,0,4,4,12,-2
Erik Brannstrom,2018-19,Ottawa Senators,NHL,2,0,0,0,0,0
Erik Brannstrom,2019-20,Belleville Senators,AHL,27,3,20,23,22,12
Erik Brannstrom,2019-20,Ottawa Senators,NHL,31,0,4,4,16,-9
Erik Brannstrom,2020-21,Langnau Tigers,Swiss-A,10,2,6,8,6,5
Erik Brannstrom,2020-21,Ottawa Senators,NHL,30,2,11,13,25,3
Erik Brannstrom,2020-21,Belleville Senators,AHL,4,0,5,5,6,-1
Erik Brannstrom,2021-22,Ottawa Senators,NHL,53,0,14,14,30,-17
Erik Brannstrom,2021-22,Belleville Senators,AHL,9,1,2,3,10,-5
Erik Brannstrom,2022-23,Ottawa Senators,NHL,74,2,16,18,38,5
Erik Brannstrom,2023-24,Ottawa Senators,NHL,76,3,17,20,36,5
Erik Brannstrom,2024-25,Vancouver Canucks*,NHL,28,3,5,8,17,-4
Erik Brannstrom,2024-25,Abbotsford Canucks*,AHL,8,2,10,12,14,11
Erik Brannstrom,2024-25,Hartford Wolf Pack,AHL,5,1,2,3,2,-1
Ty Emberson,2016-17,U.S. National Under-17 Team,USHL,34,0,8,8,12,-18
Ty Emberson,2017-18,U.S. National Under-18 Team,USHL,25,4,11,15,0,12
Ty Emberson,2017-18,U.S. National Under-18 Team,Exhibition,36,0,12,12,46,2
Ty Emberson,2018-19,U. of Wisconsin,Big-10,37,4,8,12,10,6
Ty Emberson,2019-20,U. of Wisconsin,Big-10,33,1,8,9,53,-9
Ty Emberson,2020-21,U. of Wisconsin,Big-10,31,4,9,13,6,14
Ty Emberson,2020-21,Tucson Roadrunners,AHL,5,1,0,1,0,-1
Ty Emberson,2021-22,Tucson Roadrunners,AHL,58,4,7,11,17,-25
Ty Emberson,2022-23,Hartford Wolf Pack,AHL,69,7,20,27,27,17
Ty Emberson,2023-24,San Jose Sharks,NHL,30,1,9,10,6,-4
Ty Emberson,2024-25,Edmonton Oilers,NHL,54,0,10,10,16,2
Nikita Grebenkin,2020-21,Magnitogorsk Stalnye Lisy,Rus-MHL,54,12,22,34,30,22
Nikita Grebenkin,2021-22,Magnitogorsk Metallurg,KHL,1,0,0,0,0,0
Nikita Grebenkin,2021-22,Magnitogorsk Stalnye Lisy,Rus-MHL,58,17,47,64,6,39
Nikita Grebenkin,2022-23,Orsk Yuzhny Ural,Rus-VHL,4,1,2,3,0,1
Nikita Grebenkin,2022-23,Magnitogorsk Stalnye Lisy,Rus-MHL,1,0,3,3,0,2
Nikita Grebenkin,2022-23,Magnitogorsk Metallurg,KHL,7,0,0,0,0,0
Nikita Grebenkin,2022-23,Khabarovsk Amur,KHL,45,9,17,26,21,3
Nikita Grebenkin,2023-24,Magnitogorsk Metallurg üèÜ,KHL,67,19,22,41,32,12
Nikita Grebenkin,2024-25,Toronto Maple Leafs*,NHL,7,0,0,0,2,-3
Nikita Grebenkin,2024-25,Toronto Marlies,AHL,34,9,11,20,18,0
Brian Dumoulin,2008-09,New Hampshire Jr. Monarchs,EJHL,41,7,23,30,30,
Brian Dumoulin,2009-10,Boston College,H-East,42,1,21,22,16,
Brian Dumoulin,2010-11,Boston College,H-East,37,3,30,33,6,
Brian Dumoulin,2011-12,Boston College,H-East,44,7,21,28,26,
Brian Dumoulin,2012-13,Wilkes-Barre/Scranton Penguins,AHL,73,6,18,24,18,-11
Brian Dumoulin,2013-14,Wilkes-Barre/Scranton Penguins,AHL,53,5,16,21,21,2
Brian Dumoulin,2013-14,Pittsburgh Penguins,NHL,6,0,1,1,4,1
Brian Dumoulin,2014-15,Wilkes-Barre/Scranton Penguins,AHL,62,4,29,33,18,25
Brian Dumoulin,2014-15,Pittsburgh Penguins,NHL,8,1,0,1,2,0
Brian Dumoulin,2015-16,Pittsburgh Penguins üèÜ,NHL,79,0,16,16,14,11
Brian Dumoulin,2016-17,Pittsburgh Penguins üèÜ,NHL,70,1,14,15,14,0
Brian Dumoulin,2017-18,Pittsburgh Penguins,NHL,80,5,13,18,30,-5
Brian Dumoulin,2018-19,Pittsburgh Penguins,NHL,76,3,20,23,20,31
Brian Dumoulin,2019-20,Pittsburgh Penguins,NHL,28,1,7,8,10,17
Brian Dumoulin,2020-21,Pittsburgh Penguins,NHL,41,4,10,14,12,18
Brian Dumoulin,2021-22,Pittsburgh Penguins,NHL,76,3,15,18,24,24
Brian Dumoulin,2022-23,Pittsburgh Penguins,NHL,82,1,24,25,16,-4
Brian Dumoulin,2023-24,Seattle Kraken,NHL,80,6,10,16,20,3
Brian Dumoulin,2024-25,Anaheim Ducks,NHL,54,1,12,13,8,-1
Brett Leason,2015-16,Calgary Canucks,AJHL,1,0,0,0,0,
Brett Leason,2015-16,Tri-City Americans,WHL,1,0,0,0,0,0
Brett Leason,2016-17,Calgary Canucks,AJHL,1,0,0,0,0,
Brett Leason,2016-17,Tri-City Americans,WHL,68,8,10,18,6,-1
Brett Leason,2017-18,Tri-City Americans,WHL,12,1,0,1,2,-6
Brett Leason,2017-18,Prince Albert Raiders,WHL,54,15,17,32,14,-6
Brett Leason,2018-19,Prince Albert Raiders üèÜ,WHL,55,36,53,89,28,55
Brett Leason,2019-20,Hershey Bears,AHL,50,3,11,14,12,4
Brett Leason,2020-21,Hershey Bears,AHL,33,9,11,20,8,9
Brett Leason,2021-22,Hershey Bears,AHL,31,6,7,13,14,0
Brett Leason,2021-22,Washington Capitals,NHL,36,3,3,6,4,1
Brett Leason,2022-23,Anaheim Ducks,NHL,54,6,3,9,14,-21
Brett Leason,2023-24,Anaheim Ducks,NHL,68,11,11,22,14,-7
Brett Leason,2024-25,Anaheim Ducks,NHL,45,5,10,15,14,0
Garnet Hathaway,2010-11,Brown University,ECAC,31,5,9,14,42,
Garnet Hathaway,2011-12,Brown University,ECAC,26,3,5,8,48,
Garnet Hathaway,2012-13,Brown University,ECAC,33,6,15,21,47,
Garnet Hathaway,2013-14,Brown University,ECAC,31,6,9,15,41,
Garnet Hathaway,2013-14,Abbotsford Heat,AHL,8,0,0,0,10,1
Garnet Hathaway,2014-15,Adirondack Flames,AHL,72,19,17,36,77,-8
Garnet Hathaway,2015-16,Stockton Heat,AHL,44,8,13,21,39,-4
Garnet Hathaway,2015-16,Calgary Flames,NHL,14,0,3,3,31,-1
Garnet Hathaway,2016-17,Stockton Heat,AHL,31,8,12,20,67,22
Garnet Hathaway,2016-17,Calgary Flames,NHL,26,1,4,5,44,0
Garnet Hathaway,2017-18,Calgary Flames,NHL,59,4,9,13,88,3
Garnet Hathaway,2017-18,Stockton Heat,AHL,18,11,8,19,30,16
Garnet Hathaway,2018-19,Calgary Flames,NHL,76,11,8,19,56,14
Garnet Hathaway,2019-20,Washington Capitals,NHL,66,9,7,16,79,6
Garnet Hathaway,2020-21,Washington Capitals,NHL,56,6,12,18,66,7
Garnet Hathaway,2021-22,Washington Capitals,NHL,76,14,12,26,57,19
Garnet Hathaway,2022-23,Washington Capitals,NHL,59,9,7,16,52,6
Garnet Hathaway,2022-23,Boston Bruins,NHL,25,4,2,6,17,-1
Garnet Hathaway,2023-24,Philadelphia Flyers,NHL,82,7,10,17,132,-7
Garnet Hathaway,2024-25,Philadelphia Flyers,NHL,58,8,10,18,46,4
Artturi Lehkonen,2011-12,TPS Turku,SM-liiga,18,2,2,4,8,-7
Artturi Lehkonen,2012-13,KalPa Kuopio,SM-liiga,45,14,16,30,12,12
Artturi Lehkonen,2013-14,KalPa Kuopio,SM-liiga,33,7,13,20,4,-2
Artturi Lehkonen,2014-15,Frolunda HC,SweHL,47,8,8,16,12,18
Artturi Lehkonen,2015-16,Frolunda HC üèÜ,SweHL,49,16,17,33,12,6
Artturi Lehkonen,2016-17,Montreal Canadiens,NHL,73,18,10,28,8,-1
Artturi Lehkonen,2017-18,Montreal Canadiens,NHL,66,12,9,21,20,-11
Artturi Lehkonen,2018-19,Montreal Canadiens,NHL,82,11,20,31,32,10
Artturi Lehkonen,2019-20,Montreal Canadiens,NHL,70,13,14,27,24,2
Artturi Lehkonen,2020-21,Montreal Canadiens,NHL,47,7,6,13,6,-2
Artturi Lehkonen,2021-22,Montreal Canadiens,NHL,58,13,16,29,14,0
Artturi Lehkonen,2021-22,Colorado Avalanche üèÜ,NHL,16,6,3,9,8,1
Artturi Lehkonen,2022-23,Colorado Avalanche,NHL,64,21,30,51,28,8
Artturi Lehkonen,2023-24,Colorado Avalanche,NHL,45,16,18,34,14,11
Artturi Lehkonen,2024-25,Colorado Avalanche,NHL,45,23,10,33,18,24
Haydn Fleury,2011-12,Red Deer Rebels,WHL,4,0,0,0,0,1
Haydn Fleury,2012-13,Red Deer Rebels,WHL,66,4,15,19,21,4
Haydn Fleury,2013-14,Red Deer Rebels,WHL,70,8,38,46,46,15
Haydn Fleury,2014-15,Charlotte Checkers,AHL,1,1,0,1,0,-1
Haydn Fleury,2014-15,Red Deer Rebels,WHL,63,6,22,28,63,4
Haydn Fleury,2015-16,Red Deer Rebels,WHL,56,12,29,41,50,18
Haydn Fleury,2016-17,Charlotte Checkers,AHL,69,7,19,26,8,16
Haydn Fleury,2017-18,Carolina Hurricanes,NHL,67,0,8,8,14,-2
Haydn Fleury,2017-18,Charlotte Checkers,AHL,3,1,1,2,0,3
Haydn Fleury,2018-19,Carolina Hurricanes,NHL,20,0,1,1,2,4
Haydn Fleury,2018-19,Charlotte Checkers üèÜ,AHL,28,2,8,10,32,0
Haydn Fleury,2019-20,Carolina Hurricanes,NHL,45,4,10,14,8,-2
Haydn Fleury,2020-21,Carolina Hurricanes,NHL,35,1,0,1,6,-6
Haydn Fleury,2020-21,Anaheim Ducks,NHL,12,2,1,3,2,-6
Haydn Fleury,2021-22,Seattle Kraken,NHL,36,2,2,4,13,0
Haydn Fleury,2022-23,Tampa Bay Lightning,NHL,29,0,1,1,14,-10
Haydn Fleury,2023-24,Tampa Bay Lightning,NHL,24,1,4,5,20,5
Haydn Fleury,2023-24,Syracuse Crunch,AHL,5,0,0,0,6,-1
Haydn Fleury,2024-25,Winnipeg Jets,NHL,29,0,6,6,4,-7
Olen Zellweger,2018-19,Everett Silvertips,WHL,1,0,0,0,0,0
Olen Zellweger,2019-20,Everett Silvertips,WHL,58,2,10,12,8,20
Olen Zellweger,2020-21,Everett Silvertips,WHL,11,2,11,13,2,5
Olen Zellweger,2021-22,Everett Silvertips,WHL,55,14,64,78,23,45
Olen Zellweger,2021-22,San Diego Gulls,AHL,--,--,--,--,--,--
Olen Zellweger,2022-23,Everett Silvertips,WHL,23,10,18,28,12,-5
Olen Zellweger,2022-23,Kamloops Blazers,WHL,32,22,30,52,28,35
Olen Zellweger,2023-24,Anaheim Ducks,NHL,26,2,7,9,4,-6
Olen Zellweger,2023-24,San Diego Gulls,AHL,44,12,25,37,16,-1
Olen Zellweger,2024-25,Anaheim Ducks,NHL,41,4,9,13,12,2
Sam Colangelo,2018-19,Boston Jr. Bruins,NCDC,3,0,0,0,0,
Sam Colangelo,2018-19,Chicago Steel,USHL,11,3,0,3,4,0
Sam Colangelo,2019-20,Chicago Steel,USHL,44,28,30,58,47,32
Sam Colangelo,2020-21,Northeastern University,H-East,8,0,3,3,2,-3
Sam Colangelo,2021-22,Northeastern University,H-East,29,12,15,27,18,8
Sam Colangelo,2022-23,Northeastern University,H-East,35,9,15,24,12,-4
Sam Colangelo,2023-24,Western Michigan University,NCHC,38,24,19,43,23,19
Sam Colangelo,2023-24,San Diego Gulls,AHL,4,1,3,4,0,
Sam Colangelo,2023-24,Anaheim Ducks,NHL,3,1,0,1,2,
Sam Colangelo,2024-25,Anaheim Ducks*,NHL,12,1,0,1,0,-7
Sam Colangelo,2024-25,San Diego Gulls,AHL,36,19,16,35,20,7
Zachary L'Heureux,2019-20,Moncton Wildcats,QMJHL,55,20,33,53,70,35
Zachary L'Heureux,2020-21,Halifax Mooseheads,QMJHL,33,19,20,39,47,-7
Zachary L'Heureux,2021-22,Halifax Mooseheads,QMJHL,46,22,34,56,64,-1
Zachary L'Heureux,2022-23,Halifax Mooseheads,QMJHL,33,21,21,42,34,31
Zachary L'Heureux,2023-24,Milwaukee Admirals,AHL,66,19,29,48,197,10
Zachary L'Heureux,2024-25,Nashville Predators*,NHL,45,4,9,13,52,-6
Zachary L'Heureux,2024-25,Milwaukee Admirals*,AHL,4,3,2,5,4,4
Alexey Toropchenko,2015-16,Balashikha MVD HC Jr.,Rus-MHL,21,1,2,3,4,1
Alexey Toropchenko,2016-17,Balashikha MVD HC Jr.,Rus-MHL,45,19,12,31,30,-4
Alexey Toropchenko,2016-17,Balashikha Dynamo,Rus-VHL,1,0,0,0,0,
Alexey Toropchenko,2017-18,Guelph Storm,OHL,66,17,22,39,31,-11
Alexey Toropchenko,2017-18,San Antonio Rampage,AHL,1,0,0,0,0,1
Alexey Toropchenko,2018-19,Guelph Storm üèÜ,OHL,62,17,26,43,33,5
Alexey Toropchenko,2019-20,San Antonio Rampage,AHL,59,5,4,9,21,-13
Alexey Toropchenko,2020-21,Kunlun Red Star,KHL,45,7,4,11,39,-11
Alexey Toropchenko,2021-22,Springfield Thunderbirds,AHL,42,10,10,20,24,-2
Alexey Toropchenko,2021-22,St. Louis Blues,NHL,28,2,0,2,15,-9
Alexey Toropchenko,2022-23,St. Louis Blues,NHL,69,10,9,19,12,6
Alexey Toropchenko,2022-23,Springfield Thunderbirds,AHL,5,1,2,3,4,1
Alexey Toropchenko,2023-24,St. Louis Blues,NHL,82,14,7,21,30,-3
Alexey Toropchenko,2024-25,St. Louis Blues,NHL,54,1,8,9,19,0
Jalen Chatfield,2014-15,Windsor Spitfires,OHL,60,1,20,21,35,-19
Jalen Chatfield,2015-16,Windsor Spitfires,OHL,68,10,27,37,45,22
Jalen Chatfield,2016-17,Windsor Spitfires,OHL,61,8,20,28,56,14
Jalen Chatfield,2017-18,Utica Comets,AHL,60,2,5,7,26,-2
Jalen Chatfield,2018-19,Utica Comets,AHL,34,0,6,6,15,-13
Jalen Chatfield,2019-20,Utica Comets,AHL,48,0,4,4,16,12
Jalen Chatfield,2020-21,Vancouver Canucks,NHL,18,0,1,1,12,-11
Jalen Chatfield,2021-22,Chicago Wolves üèÜ,AHL,44,6,12,18,33,14
Jalen Chatfield,2021-22,Carolina Hurricanes,NHL,16,0,3,3,8,1
Jalen Chatfield,2022-23,Carolina Hurricanes,NHL,78,6,8,14,35,23
Jalen Chatfield,2023-24,Carolina Hurricanes,NHL,72,8,14,22,24,15
Jalen Chatfield,2024-25,Carolina Hurricanes,NHL,56,5,8,13,22,21
Matvei Michkov,2020-21,St. Petersburg SKA Jr.,Rus-MHL,50,35,17,52,45,26
Matvei Michkov,2020-21,Imeni Morozova SKA Varyagi,Rus-MHL,6,3,1,4,2,
Matvei Michkov,2021-22,St. Petersburg SKA Jr.,Rus-MHL,22,22,16,38,22,14
Matvei Michkov,2021-22,Imeni Morozova SKA Varyagi,Rus-MHL,6,8,5,13,2,5
Matvei Michkov,2021-22,St. Petersburg SKA,KHL,13,2,3,5,0,2
Matvei Michkov,2022-23,Neva SKA,Rus-VHL,12,10,4,14,4,-5
Matvei Michkov,2022-23,St. Petersburg SKA,KHL,3,0,0,0,2,0
Matvei Michkov,2022-23,Sochi HC,KHL,27,9,11,20,20,1
Matvei Michkov,2023-24,St. Petersburg SKA,KHL,1,0,0,0,0,
Matvei Michkov,2023-24,Sochi HC,KHL,47,19,22,41,45,-6
Matvei Michkov,2024-25,Philadelphia Flyers,NHL,56,17,22,39,38,-10
Ross Colton,2014-15,Cedar Rapids RoughRiders,USHL,58,18,15,33,22,14
Ross Colton,2015-16,Cedar Rapids RoughRiders,USHL,55,35,31,66,79,32
Ross Colton,2016-17,U. of Vermont,H-East,33,12,15,27,22,0
Ross Colton,2017-18,U. of Vermont,H-East,36,16,7,23,47,-11
Ross Colton,2018-19,Syracuse Crunch,AHL,66,14,17,31,36,9
Ross Colton,2019-20,Syracuse Crunch,AHL,62,11,31,42,64,-2
Ross Colton,2020-21,Tampa Bay Lightning üèÜ,NHL,30,9,3,12,16,3
Ross Colton,2020-21,Syracuse Crunch,AHL,3,1,2,3,0,1
Ross Colton,2021-22,Tampa Bay Lightning,NHL,79,22,17,39,24,4
Ross Colton,2022-23,Tampa Bay Lightning,NHL,81,16,16,32,50,-8
Ross Colton,2023-24,Colorado Avalanche,NHL,80,17,23,40,61,-8
Ross Colton,2024-25,Colorado Avalanche,NHL,40,13,3,16,10,-5
Dylan Larkin,2012-13,U.S. National Development Team,USHL,37,7,7,14,40,-21
Dylan Larkin,2013-14,U.S. National Under-18 Team,USHL,26,17,9,26,24,13
Dylan Larkin,2014-15,U. of Michigan,Big-10,35,15,32,47,38,18
Dylan Larkin,2014-15,Grand Rapids Griffins,AHL,--,--,--,--,--,--
Dylan Larkin,2015-16,Detroit Red Wings,NHL,80,23,22,45,34,11
Dylan Larkin,2016-17,Detroit Red Wings,NHL,80,17,15,32,37,-28
Dylan Larkin,2017-18,Detroit Red Wings,NHL,82,16,47,63,61,-9
Dylan Larkin,2018-19,Detroit Red Wings,NHL,76,32,41,73,75,-6
Dylan Larkin,2019-20,Detroit Red Wings,NHL,71,19,34,53,39,-21
Dylan Larkin,2020-21,Detroit Red Wings,NHL,44,9,14,23,34,-14
Dylan Larkin,2021-22,Detroit Red Wings,NHL,71,31,38,69,47,-18
Dylan Larkin,2022-23,Detroit Red Wings,NHL,80,32,47,79,45,-7
Dylan Larkin,2023-24,Detroit Red Wings,NHL,68,33,36,69,39,5
Dylan Larkin,2024-25,Detroit Red Wings,NHL,56,24,28,52,36,-1
Ondrej Palat,2009-10,Drummondville Voltigeurs,QMJHL,59,17,23,40,24,33
Ondrej Palat,2010-11,Drummondville Voltigeurs,QMJHL,61,39,57,96,24,37
Ondrej Palat,2011-12,Norfolk Admirals üèÜ,AHL,61,9,21,30,10,6
Ondrej Palat,2012-13,Syracuse Crunch,AHL,56,13,39,52,35,26
Ondrej Palat,2012-13,Tampa Bay Lightning,NHL,14,2,2,4,0,5
Ondrej Palat,2013-14,Tampa Bay Lightning,NHL,81,23,36,59,20,32
Ondrej Palat,2014-15,Tampa Bay Lightning,NHL,75,16,47,63,24,31
Ondrej Palat,2015-16,Tampa Bay Lightning,NHL,62,16,24,40,20,10
Ondrej Palat,2016-17,Tampa Bay Lightning,NHL,75,17,35,52,39,8
Ondrej Palat,2017-18,Tampa Bay Lightning,NHL,56,11,24,35,6,16
Ondrej Palat,2018-19,Tampa Bay Lightning,NHL,64,8,26,34,20,4
Ondrej Palat,2019-20,Tampa Bay Lightning üèÜ,NHL,69,17,24,41,22,25
Ondrej Palat,2020-21,Tampa Bay Lightning üèÜ,NHL,55,15,31,46,26,1
Ondrej Palat,2021-22,Tampa Bay Lightning,NHL,77,18,31,49,20,15
Ondrej Palat,2022-23,New Jersey Devils,NHL,49,8,15,23,6,5
Ondrej Palat,2023-24,New Jersey Devils,NHL,71,11,20,31,37,-9
Ondrej Palat,2024-25,New Jersey Devils,NHL,55,12,10,22,8,0
Jake Neighbours,2017-18,Edmonton Oil Kings,WHL,11,0,4,4,6,-2
Jake Neighbours,2018-19,Edmonton Oil Kings,WHL,47,11,13,24,25,5
Jake Neighbours,2019-20,Edmonton Oil Kings,WHL,64,23,47,70,39,15
Jake Neighbours,2020-21,Edmonton Oil Kings,WHL,19,9,24,33,17,29
Jake Neighbours,2021-22,Edmonton Oil Kings üèÜ,WHL,30,17,28,45,38,24
Jake Neighbours,2021-22,St. Louis Blues,NHL,9,1,1,2,2,-2
Jake Neighbours,2022-23,St. Louis Blues,NHL,43,6,4,10,24,-19
Jake Neighbours,2022-23,Springfield Thunderbirds,AHL,23,9,7,16,2,1
Jake Neighbours,2023-24,St. Louis Blues,NHL,77,27,11,38,21,-16
Jake Neighbours,2024-25,St. Louis Blues,NHL,56,13,12,25,37,-9
Owen Sillinger,2014-15,Melville Millionaires,SJHL,3,0,0,0,0,
Owen Sillinger,2015-16,Penticton Vees,BCHL,58,16,29,45,18,
Owen Sillinger,2016-17,Penticton Vees üèÜ,BCHL,57,17,24,41,34,
Owen Sillinger,2017-18,Penticton Vees,BCHL,56,33,34,67,36,
Owen Sillinger,2018-19,Bemidji State University,WCHA,38,10,9,19,34,0
Owen Sillinger,2019-20,Bemidji State University,WCHA,37,14,20,34,36,11
Owen Sillinger,2020-21,Bemidji State University,WCHA,20,10,5,15,14,3
Owen Sillinger,2021-22,Bemidji State University,CCHA,39,17,30,47,41,10
Owen Sillinger,2021-22,Cleveland Monsters,AHL,17,3,6,9,4,-7
Owen Sillinger,2022-23,Cleveland Monsters,AHL,72,11,25,36,60,-15
Owen Sillinger,2023-24,Cleveland Monsters,AHL,69,11,29,40,66,
Owen Sillinger,2024-25,Columbus Blue Jackets*,NHL,1,0,0,0,2,0
Owen Sillinger,2024-25,Cleveland Monsters,AHL,44,11,18,29,18,-5
Alexandre Texier,2016-17,Grenoble,France,40,10,9,19,69,-1
Alexandre Texier,2017-18,KalPa Kuopio,SM-liiga,53,13,9,22,38,5
Alexandre Texier,2018-19,KalPa Kuopio,SM-liiga,55,14,27,41,36,-11
Alexandre Texier,2018-19,Cleveland Monsters,AHL,7,5,2,7,4,6
Alexandre Texier,2018-19,Columbus Blue Jackets,NHL,2,1,0,1,0,3
Alexandre Texier,2019-20,Columbus Blue Jackets,NHL,36,6,7,13,10,3
Alexandre Texier,2020-21,Grenoble,France,2,1,0,1,2,-1
Alexandre Texier,2020-21,Columbus Blue Jackets,NHL,49,4,11,15,22,-13
Alexandre Texier,2021-22,Columbus Blue Jackets,NHL,36,11,9,20,12,0
Alexandre Texier,2022-23,Zurich SC,Swiss-A,46,13,22,35,30,16
Alexandre Texier,2023-24,Columbus Blue Jackets,NHL,78,12,18,30,38,-5
Alexandre Texier,2024-25,St. Louis Blues,NHL,27,4,5,9,8,-3
Ryker Evans,2018-19,Regina Pats,WHL,45,1,10,11,32,-19
Ryker Evans,2019-20,Regina Pats,WHL,63,7,24,31,81,-12
Ryker Evans,2020-21,Regina Pats,WHL,24,3,25,28,37,-4
Ryker Evans,2021-22,Regina Pats,WHL,63,14,47,61,96,9
Ryker Evans,2022-23,Coachella Valley Firebirds,AHL,71,6,38,44,74,19
Ryker Evans,2023-24,Seattle Kraken,NHL,36,1,8,9,20,-5
Ryker Evans,2023-24,Coachella Valley Firebirds,AHL,25,2,13,15,28,
Ryker Evans,2024-25,Seattle Kraken,NHL,50,5,16,21,18,2
Maxim Tsyplakov,2015-16,Moscow Spartak Jr.,Rus-MHL,24,3,4,7,9,-6
Maxim Tsyplakov,2016-17,Moscow Spartak Jr.,Rus-MHL,34,7,9,16,21,4
Maxim Tsyplakov,2016-17,Voskresensk Khimik,Rus-VHL,11,1,3,4,4,-1
Maxim Tsyplakov,2017-18,Moscow Spartak,KHL,20,0,0,0,4,-5
Maxim Tsyplakov,2017-18,Moscow Spartak Jr.,Rus-MHL,20,7,5,12,14,-3
Maxim Tsyplakov,2017-18,Voskresensk Khimik,Rus-VHL,5,1,0,1,2,-2
Maxim Tsyplakov,2018-19,Moscow Spartak,KHL,31,4,5,9,29,5
Maxim Tsyplakov,2018-19,Moscow Spartak Jr.,Rus-MHL,5,1,0,1,2,1
Maxim Tsyplakov,2018-19,Voskresensk Khimik,Rus-VHL,15,1,4,5,2,3
Maxim Tsyplakov,2019-20,Moscow Spartak,KHL,52,5,6,11,18,-1
Maxim Tsyplakov,2020-21,Voskresensk Khimik,Rus-VHL,1,0,0,0,0,-1
Maxim Tsyplakov,2020-21,Moscow Spartak,KHL,58,9,8,17,32,-13
Maxim Tsyplakov,2021-22,Moscow Spartak,KHL,38,4,8,12,28,-3
Maxim Tsyplakov,2021-22,Voskresensk Khimik,Rus-VHL,1,0,0,0,4,1
Maxim Tsyplakov,2022-23,Moscow Spartak,KHL,63,10,15,25,30,5
Maxim Tsyplakov,2023-24,Moscow Spartak,KHL,65,31,16,47,37,12
Maxim Tsyplakov,2024-25,New York Islanders,NHL,51,7,18,25,33,9
Ryan Nugent-Hopkins,2008-09,Red Deer Rebels,WHL,5,2,4,6,0,-6
Ryan Nugent-Hopkins,2009-10,Red Deer Rebels,WHL,67,24,41,65,28,-4
Ryan Nugent-Hopkins,2010-11,Red Deer Rebels,WHL,69,31,75,106,51,29
Ryan Nugent-Hopkins,2011-12,Edmonton Oilers,NHL,62,18,34,52,16,-2
Ryan Nugent-Hopkins,2012-13,Oklahoma City Barons,AHL,19,8,12,20,6,7
Ryan Nugent-Hopkins,2012-13,Edmonton Oilers,NHL,40,4,20,24,8,3
Ryan Nugent-Hopkins,2013-14,Edmonton Oilers,NHL,80,19,37,56,26,-12
Ryan Nugent-Hopkins,2014-15,Edmonton Oilers,NHL,76,24,32,56,25,-12
Ryan Nugent-Hopkins,2015-16,Edmonton Oilers,NHL,55,12,22,34,18,-9
Ryan Nugent-Hopkins,2016-17,Edmonton Oilers,NHL,82,18,25,43,29,-10
Ryan Nugent-Hopkins,2017-18,Edmonton Oilers,NHL,62,24,24,48,20,10
Ryan Nugent-Hopkins,2018-19,Edmonton Oilers,NHL,82,28,41,69,26,-13
Ryan Nugent-Hopkins,2019-20,Edmonton Oilers,NHL,65,22,39,61,33,1
Ryan Nugent-Hopkins,2020-21,Edmonton Oilers,NHL,52,16,19,35,22,-4
Ryan Nugent-Hopkins,2021-22,Edmonton Oilers,NHL,63,11,39,50,16,3
Ryan Nugent-Hopkins,2022-23,Edmonton Oilers,NHL,82,37,67,104,35,12
Ryan Nugent-Hopkins,2023-24,Edmonton Oilers,NHL,80,18,49,67,36,10
Ryan Nugent-Hopkins,2024-25,Edmonton Oilers,NHL,55,15,20,35,18,4
Frank Nazar,2020-21,U.S. National Development Team,USHL,31,20,16,36,16,7
Frank Nazar,2021-22,U.S. National Development Team,USHL,24,15,20,35,8,26
Frank Nazar,2022-23,U. of Michigan,Big-10,13,2,5,7,0,6
Frank Nazar,2023-24,U. of Michigan,Big-10,41,17,24,41,18,-7
Frank Nazar,2023-24,Chicago Blackhawks,NHL,3,1,0,1,0,-4
Frank Nazar,2024-25,Rockford IceHogs*,AHL,21,11,13,24,8,1
Frank Nazar,2024-25,Chicago Blackhawks,NHL,26,4,6,10,8,-5
Justin Danforth,2009-10,Cobourg Cougars,OJHL,3,0,0,0,2,-1
Justin Danforth,2010-11,Cobourg Cougars,OJHL,47,13,23,36,26,
Justin Danforth,2011-12,Cobourg Cougars,OJHL,41,22,27,49,40,
Justin Danforth,2012-13,Cobourg Cougars,OJHL,43,22,34,56,42,
Justin Danforth,2013-14,Sacred Heart University,AHA,36,5,24,29,24,
Justin Danforth,2014-15,Sacred Heart University,AHA,38,7,15,22,26,-1
Justin Danforth,2015-16,Sacred Heart University,AHA,36,20,21,41,22,9
Justin Danforth,2016-17,Sacred Heart University,AHA,37,10,22,32,53,-5
Justin Danforth,2016-17,Reading Royals,ECHL,3,1,2,3,2,-1
Justin Danforth,2016-17,Bridgeport Sound Tigers,AHL,1,0,0,0,0,0
Justin Danforth,2016-17,Rochester Americans,AHL,5,2,0,2,4,1
Justin Danforth,2017-18,Cincinnati Cyclones,ECHL,44,28,31,59,40,26
Justin Danforth,2017-18,Rochester Americans,AHL,15,2,3,5,12,1
Justin Danforth,2018-19,Lukko Rauma,SM-liiga,59,18,34,52,73,7
Justin Danforth,2019-20,Lukko Rauma,SM-liiga,56,27,33,60,26,26
Justin Danforth,2020-21,Podolsk Vityaz,KHL,58,23,32,55,50,3
Justin Danforth,2021-22,Columbus Blue Jackets,NHL,45,10,4,14,10,-5
Justin Danforth,2021-22,Cleveland Monsters,AHL,8,2,3,5,0,-6
Justin Danforth,2022-23,Columbus Blue Jackets,NHL,6,2,1,3,4,-3
Justin Danforth,2023-24,Columbus Blue Jackets,NHL,71,10,16,26,26,-10
Justin Danforth,2024-25,Columbus Blue Jackets,NHL,35,5,7,12,10,-8
Nick Blankenburg,2017-18,Okotoks Oilers,AJHL,57,16,26,42,65,
Nick Blankenburg,2018-19,U. of Michigan,Big-10,34,2,8,10,12,11
Nick Blankenburg,2019-20,U. of Michigan,Big-10,35,4,12,16,14,3
Nick Blankenburg,2020-21,U. of Michigan,Big-10,26,5,8,13,14,19
Nick Blankenburg,2021-22,U. of Michigan,Big-10,38,14,15,29,22,17
Nick Blankenburg,2021-22,Columbus Blue Jackets,NHL,7,1,2,3,4,-3
Nick Blankenburg,2022-23,Columbus Blue Jackets,NHL,36,4,10,14,16,-16
Nick Blankenburg,2023-24,Columbus Blue Jackets,NHL,12,1,0,1,4,1
Nick Blankenburg,2023-24,Cleveland Monsters,AHL,24,3,10,13,22,7
Nick Blankenburg,2024-25,Milwaukee Admirals*,AHL,13,3,5,8,2,0
Nick Blankenburg,2024-25,Nashville Predators,NHL,32,3,4,7,10,9
Chase Bradley,2018-19,Omaha Lancers,USHL,37,3,1,4,8,-2
Chase Bradley,2019-20,Omaha Lancers,USHL,34,7,12,19,77,16
Chase Bradley,2020-21,Sioux City Musketeers,USHL,52,22,18,40,82,29
Chase Bradley,2021-22,U. of Connecticut,H-East,29,4,5,9,14,5
Chase Bradley,2022-23,U. of Connecticut,H-East,35,10,10,20,61,6
Chase Bradley,2023-24,U. of Connecticut,H-East,31,11,11,22,53,4
Chase Bradley,2024-25,Colorado Avalanche*,NHL,2,0,0,0,0,0
Chase Bradley,2024-25,Colorado Eagles,AHL,41,9,4,13,27,9
Jordan Martinook,2008-09,Drayton Valley Thunder,AJHL,2,0,0,0,0,
Jordan Martinook,2009-10,Drayton Valley Thunder,AJHL,59,21,19,40,48,
Jordan Martinook,2010-11,Vancouver Giants,WHL,72,11,17,28,67,1
Jordan Martinook,2011-12,Vancouver Giants,WHL,72,40,24,64,80,14
Jordan Martinook,2012-13,Portland Pirates,AHL,53,9,10,19,30,-4
Jordan Martinook,2013-14,Portland Pirates,AHL,67,14,16,30,48,-9
Jordan Martinook,2014-15,Portland Pirates,AHL,62,15,28,43,41,9
Jordan Martinook,2014-15,Arizona Coyotes,NHL,8,0,1,1,0,-3
Jordan Martinook,2015-16,Arizona Coyotes,NHL,81,9,15,24,18,-9
Jordan Martinook,2016-17,Arizona Coyotes,NHL,77,11,14,25,40,-8
Jordan Martinook,2017-18,Arizona Coyotes,NHL,81,6,9,15,45,-24
Jordan Martinook,2018-19,Carolina Hurricanes,NHL,82,15,10,25,38,1
Jordan Martinook,2019-20,Carolina Hurricanes,NHL,45,2,11,13,22,-2
Jordan Martinook,2020-21,Carolina Hurricanes,NHL,44,4,9,13,25,-3
Jordan Martinook,2021-22,Carolina Hurricanes,NHL,59,6,9,15,22,1
Jordan Martinook,2022-23,Carolina Hurricanes,NHL,82,13,21,34,61,7
Jordan Martinook,2023-24,Carolina Hurricanes,NHL,82,14,18,32,36,-1
Jordan Martinook,2024-25,Carolina Hurricanes,NHL,56,10,16,26,10,15
Simon Benoit,2015-16,Shawinigan Cataractes,QMJHL,55,1,2,3,22,1
Simon Benoit,2016-17,Shawinigan Cataractes,QMJHL,64,2,10,12,47,4
Simon Benoit,2017-18,Shawinigan Cataractes,QMJHL,63,5,23,28,67,-37
Simon Benoit,2018-19,San Diego Gulls,AHL,65,2,14,16,33,16
Simon Benoit,2019-20,San Diego Gulls,AHL,56,4,15,19,39,15
Simon Benoit,2020-21,San Diego Gulls,AHL,38,1,7,8,32,4
Simon Benoit,2020-21,Anaheim Ducks,NHL,6,0,0,0,2,-3
Simon Benoit,2021-22,Anaheim Ducks,NHL,53,1,4,5,22,-5
Simon Benoit,2021-22,San Diego Gulls,AHL,1,0,0,0,0,0
Simon Benoit,2022-23,Anaheim Ducks,NHL,78,3,7,10,60,-29
Simon Benoit,2023-24,Toronto Maple Leafs,NHL,64,1,4,5,56,7
Simon Benoit,2023-24,Toronto Marlies,AHL,2,0,0,0,0,-2
Simon Benoit,2024-25,Toronto Maple Leafs,NHL,51,0,4,4,37,1
Nikolas Matinpalo,2018-19,Ilves Tampere,SM-liiga,30,2,4,6,10,7
Nikolas Matinpalo,2018-19,KooVee Tampere,Mestis,2,0,0,0,0,-5
Nikolas Matinpalo,2019-20,Ilves Tampere,SM-liiga,33,0,1,1,47,-1
Nikolas Matinpalo,2019-20,KooVee Tampere,Mestis,13,1,2,3,10,1
Nikolas Matinpalo,2020-21,Ilves Tampere,SM-liiga,11,0,0,0,6,2
Nikolas Matinpalo,2020-21,KooVee Tampere,Mestis,1,0,1,1,0,0
Nikolas Matinpalo,2020-21,Assat Pori,SM-liiga,30,1,2,3,18,-2
Nikolas Matinpalo,2021-22,Assat Pori,SM-liiga,50,4,4,8,20,-4
Nikolas Matinpalo,2022-23,Assat Pori,SM-liiga,51,7,9,16,20,2
Nikolas Matinpalo,2023-24,Ottawa Senators,NHL,4,0,0,0,0,1
Nikolas Matinpalo,2023-24,Belleville Senators,AHL,67,4,10,14,26,15
Nikolas Matinpalo,2024-25,Belleville Senators*,AHL,24,2,6,8,10,-4
Nikolas Matinpalo,2024-25,Ottawa Senators,NHL,18,0,0,0,6,-1
Mason Marchment,2013-14,Cobourg Cougars,OJHL,51,22,21,43,84,
Mason Marchment,2014-15,Erie Otters,OHL,54,8,18,26,29,12
Mason Marchment,2015-16,Hamilton Bulldogs,OHL,34,10,23,33,30,-7
Mason Marchment,2015-16,Mississauga Steelheads,OHL,27,10,8,18,22,-6
Mason Marchment,2015-16,Toronto Marlies,AHL,3,0,0,0,0,0
Mason Marchment,2016-17,Toronto Marlies,AHL,9,1,0,1,6,-2
Mason Marchment,2016-17,Orlando Solar Bears,ECHL,35,14,6,20,27,1
Mason Marchment,2017-18,Toronto Marlies üèÜ,AHL,44,11,15,26,36,12
Mason Marchment,2018-19,Toronto Marlies,AHL,44,13,12,25,60,5
Mason Marchment,2019-20,Toronto Maple Leafs,NHL,4,0,1,1,0,0
Mason Marchment,2019-20,Toronto Marlies,AHL,24,13,5,18,28,-6
Mason Marchment,2019-20,Springfield Thunderbirds,AHL,6,0,2,2,8,0
Mason Marchment,2020-21,Florida Panthers,NHL,33,2,8,10,18,4
Mason Marchment,2021-22,Florida Panthers,NHL,54,18,29,47,53,29
Mason Marchment,2022-23,Dallas Stars,NHL,68,12,19,31,80,-6
Mason Marchment,2023-24,Dallas Stars,NHL,81,22,31,53,54,22
Mason Marchment,2024-25,Dallas Stars,NHL,37,14,15,29,37,11
Mathieu Joseph,2013-14,Saint John Sea Dogs,QMJHL,30,1,10,11,10,-3
Mathieu Joseph,2014-15,Saint John Sea Dogs,QMJHL,59,21,21,42,46,18
Mathieu Joseph,2015-16,Saint John Sea Dogs,QMJHL,58,33,40,73,57,35
Mathieu Joseph,2016-17,Saint John Sea Dogs üèÜ,QMJHL,54,36,44,80,57,37
Mathieu Joseph,2017-18,Syracuse Crunch,AHL,70,15,38,53,41,10
Mathieu Joseph,2018-19,Tampa Bay Lightning,NHL,70,13,13,26,26,5
Mathieu Joseph,2019-20,Tampa Bay Lightning,NHL,37,4,3,7,16,-2
Mathieu Joseph,2019-20,Syracuse Crunch,AHL,29,6,15,21,14,-7
Mathieu Joseph,2020-21,Tampa Bay Lightning üèÜ,NHL,56,12,7,19,10,3
Mathieu Joseph,2021-22,Tampa Bay Lightning,NHL,58,8,10,18,23,4
Mathieu Joseph,2021-22,Ottawa Senators,NHL,11,4,8,12,6,8
Mathieu Joseph,2022-23,Ottawa Senators,NHL,56,3,15,18,36,5
Mathieu Joseph,2023-24,Ottawa Senators,NHL,72,11,24,35,51,-4
Mathieu Joseph,2024-25,St. Louis Blues,NHL,37,3,4,7,12,-7
Ilya Solovyov,2019-20,Saginaw Spirit,OHL,53,7,33,40,35,43
Ilya Solovyov,2020-21,Minsk Dynamo,KHL,41,2,7,9,36,-3
Ilya Solovyov,2021-22,Stockton Heat,AHL,51,3,5,8,24,5
Ilya Solovyov,2022-23,Calgary Wranglers,AHL,68,4,14,18,38,18
Ilya Solovyov,2023-24,Calgary Flames,NHL,10,0,3,3,4,-3
Ilya Solovyov,2023-24,Calgary Wranglers,AHL,51,5,10,15,34,2
Ilya Solovyov,2024-25,Calgary Wranglers*,AHL,43,6,15,21,16,16
Ilya Solovyov,2024-25,Calgary Flames,NHL,1,0,0,0,0,-1
Mason Appleton,2014-15,Tri-City Storm,USHL,54,12,28,40,84,-3
Mason Appleton,2015-16,Michigan State University,Big-10,37,5,17,22,32,-30
Mason Appleton,2016-17,Michigan State University,Big-10,35,12,19,31,37,-15
Mason Appleton,2017-18,Manitoba Moose,AHL,76,22,44,66,57,14
Mason Appleton,2018-19,Manitoba Moose,AHL,40,15,17,32,24,-5
Mason Appleton,2018-19,Winnipeg Jets,NHL,36,3,7,10,4,9
Mason Appleton,2019-20,Winnipeg Jets,NHL,46,5,3,8,20,-9
Mason Appleton,2019-20,Manitoba Moose,AHL,4,0,1,1,0,-4
Mason Appleton,2020-21,Winnipeg Jets,NHL,56,12,13,25,14,11
Mason Appleton,2021-22,Seattle Kraken,NHL,49,6,11,17,14,-4
Mason Appleton,2021-22,Winnipeg Jets,NHL,19,2,2,4,16,3
Mason Appleton,2022-23,Winnipeg Jets,NHL,41,5,11,16,8,2
Mason Appleton,2023-24,Winnipeg Jets,NHL,82,14,22,36,26,16
Mason Appleton,2024-25,Winnipeg Jets,NHL,45,7,10,17,12,7
Mikael Pyyhtia,2019-20,TPS Turku,SM-liiga,2,0,1,1,0,0
Mikael Pyyhtia,2020-21,TPS Turku,SM-liiga,35,3,4,7,4,3
Mikael Pyyhtia,2021-22,TPS Turku,SM-liiga,56,21,14,35,6,8
Mikael Pyyhtia,2022-23,Columbus Blue Jackets,NHL,2,0,1,1,2,-2
Mikael Pyyhtia,2022-23,TPS Turku,SM-liiga,47,7,13,20,16,-10
Mikael Pyyhtia,2022-23,Cleveland Monsters,AHL,7,3,0,3,0,0
Mikael Pyyhtia,2023-24,Cleveland Monsters,AHL,60,7,21,28,6,-1
Mikael Pyyhtia,2023-24,Columbus Blue Jackets,NHL,17,0,2,2,0,-5
Mikael Pyyhtia,2024-25,Columbus Blue Jackets*,NHL,46,4,3,7,6,-10
Mikael Pyyhtia,2024-25,Cleveland Monsters,AHL,8,1,4,5,2,0
Nolan Allan,2018-19,Prince Albert Raiders,WHL,7,0,1,1,2,0
Nolan Allan,2019-20,Prince Albert Raiders,WHL,58,2,6,8,25,16
Nolan Allan,2020-21,La Ronge Ice Wolves,SJHL,5,2,3,5,10,
Nolan Allan,2020-21,Prince Albert Raiders,WHL,16,1,1,2,21,-3
Nolan Allan,2021-22,Prince Albert Raiders,WHL,65,7,34,41,69,-4
Nolan Allan,2022-23,Prince Albert Raiders,WHL,16,4,7,11,10,-5
Nolan Allan,2022-23,Seattle Thunderbirds üèÜ,WHL,41,7,9,16,40,27
Nolan Allan,2023-24,Rockford IceHogs,AHL,60,5,12,17,47,2
Nolan Allan,2024-25,Chicago Blackhawks,NHL,41,1,7,8,16,-13
Nikita Kucherov,2009-10,CSKA Red Army Jr.,Rus-MHL,53,29,25,54,40,23
Nikita Kucherov,2010-11,CSKA Red Army Jr.,Rus-MHL,41,27,31,58,81,42
Nikita Kucherov,2010-11,CSKA Moscow,KHL,8,0,2,2,0,-3
Nikita Kucherov,2011-12,CSKA Red Army Jr.,Rus-MHL,23,24,19,43,40,16
Nikita Kucherov,2011-12,CSKA Moscow,KHL,18,1,3,4,4,-1
Nikita Kucherov,2012-13,Quebec Remparts,QMJHL,6,3,7,10,2,-1
Nikita Kucherov,2012-13,Rouyn-Noranda Huskies,QMJHL,27,26,27,53,12,18
Nikita Kucherov,2013-14,Syracuse Crunch,AHL,17,13,11,24,10,1
Nikita Kucherov,2013-14,Tampa Bay Lightning,NHL,52,9,9,18,14,3
Nikita Kucherov,2014-15,Tampa Bay Lightning,NHL,82,29,36,65,37,38
Nikita Kucherov,2015-16,Tampa Bay Lightning,NHL,77,30,36,66,30,9
Nikita Kucherov,2016-17,Tampa Bay Lightning,NHL,74,40,45,85,38,13
Nikita Kucherov,2017-18,Tampa Bay Lightning,NHL,80,39,61,100,42,15
Nikita Kucherov,2018-19,Tampa Bay Lightning,NHL,82,41,87,128,62,24
Nikita Kucherov,2019-20,Tampa Bay Lightning üèÜ,NHL,68,33,52,85,38,26
Nikita Kucherov,2020-21,Tampa Bay Lightning üèÜ,NHL,--,--,--,--,--,--
Nikita Kucherov,2021-22,Tampa Bay Lightning,NHL,47,25,44,69,22,1
Nikita Kucherov,2022-23,Tampa Bay Lightning,NHL,82,30,83,113,36,-2
Nikita Kucherov,2023-24,Tampa Bay Lightning,NHL,81,44,100,144,22,8
Nikita Kucherov,2024-25,Tampa Bay Lightning,NHL,52,25,57,82,35,12
Shayne Gostisbehere,2011-12,Union College,ECAC,41,5,17,22,20,
Shayne Gostisbehere,2012-13,Union College,ECAC,36,8,18,26,39,
Shayne Gostisbehere,2013-14,Union College,ECAC,42,9,25,34,26,
Shayne Gostisbehere,2013-14,Adirondack Phantoms,AHL,2,0,0,0,0,-2
Shayne Gostisbehere,2014-15,Lehigh Valley Phantoms,AHL,5,0,5,5,0,-1
Shayne Gostisbehere,2014-15,Philadelphia Flyers,NHL,2,0,0,0,0,-2
Shayne Gostisbehere,2015-16,Lehigh Valley Phantoms,AHL,14,2,8,10,6,-2
Shayne Gostisbehere,2015-16,Philadelphia Flyers,NHL,64,17,29,46,24,8
Shayne Gostisbehere,2016-17,Philadelphia Flyers,NHL,76,7,32,39,32,-21
Shayne Gostisbehere,2017-18,Philadelphia Flyers,NHL,78,13,52,65,25,10
Shayne Gostisbehere,2018-19,Philadelphia Flyers,NHL,78,9,28,37,22,-20
Shayne Gostisbehere,2019-20,Philadelphia Flyers,NHL,42,5,7,12,20,-4
Shayne Gostisbehere,2019-20,Lehigh Valley Phantoms,AHL,2,0,1,1,0,-1
Shayne Gostisbehere,2020-21,Philadelphia Flyers,NHL,41,9,11,20,6,-2
Shayne Gostisbehere,2021-22,Arizona Coyotes,NHL,82,14,37,51,26,-23
Shayne Gostisbehere,2022-23,Arizona Coyotes,NHL,52,10,21,31,28,-6
Shayne Gostisbehere,2022-23,Carolina Hurricanes,NHL,23,3,7,10,4,1
Shayne Gostisbehere,2023-24,Detroit Red Wings,NHL,81,10,46,56,16,-16
Shayne Gostisbehere,2024-25,Carolina Hurricanes,NHL,48,6,23,29,20,-6
Ethan Del Mastro,2019-20,Mississauga Steelheads,OHL,57,0,7,7,28,-6
Ethan Del Mastro,2021-22,Mississauga Steelheads,OHL,68,7,41,48,91,34
Ethan Del Mastro,2022-23,Mississauga Steelheads,OHL,22,2,19,21,35,4
Ethan Del Mastro,2022-23,Sarnia Sting,OHL,30,5,33,38,47,12
Ethan Del Mastro,2023-24,Rockford IceHogs,AHL,69,7,30,37,54,14
Ethan Del Mastro,2023-24,Chicago Blackhawks,NHL,2,0,0,0,0,
Ethan Del Mastro,2024-25,Rockford IceHogs*,AHL,42,0,8,8,39,5
Ethan Del Mastro,2024-25,Chicago Blackhawks,NHL,6,0,1,1,2,0
Samuel Bolduc,2016-17,Blainville-Boisbriand Armada,QMJHL,6,0,0,0,0,0
Samuel Bolduc,2017-18,Blainville-Boisbriand Armada,QMJHL,57,2,12,14,8,16
Samuel Bolduc,2018-19,Blainville-Boisbriand Armada,QMJHL,65,9,28,37,27,-32
Samuel Bolduc,2019-20,Blainville-Boisbriand Armada,QMJHL,32,7,9,16,14,7
Samuel Bolduc,2019-20,Sherbrooke Phoenix,QMJHL,29,4,23,27,12,6
Samuel Bolduc,2020-21,Bridgeport Sound Tigers,AHL,24,6,8,14,10,5
Samuel Bolduc,2021-22,Bridgeport Islanders,AHL,57,2,5,7,16,-10
Samuel Bolduc,2022-23,New York Islanders,NHL,17,2,1,3,2,5
Samuel Bolduc,2022-23,Bridgeport Islanders,AHL,56,10,25,35,31,-13
Samuel Bolduc,2023-24,New York Islanders,NHL,34,2,3,5,6,-4
Samuel Bolduc,2023-24,Bridgeport Islanders,AHL,5,1,0,1,2,2
Samuel Bolduc,2024-25,New York Islanders*,NHL,1,0,0,0,0,-1
Samuel Bolduc,2024-25,Bridgeport Islanders,AHL,46,6,21,27,6,-17
Jacob Gaucher,2017-18,Val d'Or Foreurs,QMJHL,10,0,0,0,4,-5
Jacob Gaucher,2018-19,Val d'Or Foreurs,QMJHL,68,12,12,24,22,-29
Jacob Gaucher,2019-20,Val d'Or Foreurs,QMJHL,62,14,24,38,38,-17
Jacob Gaucher,2020-21,Val d'Or Foreurs,QMJHL,36,4,7,11,31,7
Jacob Gaucher,2021-22,Baie-Comeau Drakkar,QMJHL,66,35,33,68,26,13
Jacob Gaucher,2022-23,Reading Royals,ECHL,71,22,39,61,30,22
Jacob Gaucher,2023-24,Lehigh Valley Phantoms,AHL,59,8,8,16,18,-7
Jacob Gaucher,2023-24,Reading Royals,ECHL,3,0,0,0,0,-4
Jacob Gaucher,2024-25,Philadelphia Flyers*,NHL,4,0,0,0,0,0
Jacob Gaucher,2024-25,Lehigh Valley Phantoms,AHL,50,15,15,30,41,3
Dylan Duke,2019-20,U.S. National Under-17 Team,USHL,26,12,10,22,20,5
Dylan Duke,2019-20,U.S. National Under-18 Team,USHL,6,0,1,1,2,-2
Dylan Duke,2020-21,U.S. National Development Team,USHL,26,10,7,17,20,2
Dylan Duke,2021-22,U. of Michigan,Big-10,41,10,9,19,20,7
Dylan Duke,2022-23,U. of Michigan,Big-10,41,18,14,32,43,10
Dylan Duke,2023-24,U. of Michigan,Big-10,41,26,23,49,30,8
Dylan Duke,2023-24,Syracuse Crunch,AHL,3,0,0,0,0,-3
Dylan Duke,2024-25,Tampa Bay Lightning*,NHL,2,1,0,1,0,0
Dylan Duke,2024-25,Syracuse Crunch,AHL,39,15,9,24,28,7
Henri Jokiharju,2016-17,Portland Winterhawks,WHL,71,9,39,48,38,14
Henri Jokiharju,2017-18,Portland Winterhawks,WHL,63,12,59,71,14,47
Henri Jokiharju,2018-19,Chicago Blackhawks,NHL,38,0,12,12,16,-7
Henri Jokiharju,2018-19,Rockford IceHogs,AHL,30,2,15,17,14,7
Henri Jokiharju,2019-20,Buffalo Sabres,NHL,69,4,11,15,32,-6
Henri Jokiharju,2020-21,Buffalo Sabres,NHL,46,3,5,8,4,-11
Henri Jokiharju,2021-22,Buffalo Sabres,NHL,60,3,16,19,20,-8
Henri Jokiharju,2022-23,Buffalo Sabres,NHL,60,3,10,13,30,-12
Henri Jokiharju,2023-24,Buffalo Sabres,NHL,74,3,17,20,24,14
Henri Jokiharju,2024-25,Buffalo Sabres,NHL,39,1,3,4,12,3
Marco Kasper,2019-20,Klagenfurt II AC,AlpsHL,3,1,1,2,0,-1
Marco Kasper,2020-21,Rogle BK Jr.,Swe-Jr,6,2,0,2,6,-3
Marco Kasper,2020-21,Rogle BK Angelholm,SweHL,10,0,1,1,4,0
Marco Kasper,2021-22,Rogle BK Angelholm,SweHL,46,7,4,11,17,-10
Marco Kasper,2021-22,Rogle BK Jr.,Swe-Jr,12,6,7,13,10,2
Marco Kasper,2022-23,Detroit Red Wings,NHL,1,0,0,0,0,0
Marco Kasper,2022-23,Rogle BK Angelholm,SweHL,52,8,15,23,72,7
Marco Kasper,2023-24,Grand Rapids Griffins,AHL,71,14,21,35,30,9
Marco Kasper,2024-25,Grand Rapids Griffins*,AHL,2,1,1,2,7,0
Marco Kasper,2024-25,Detroit Red Wings,NHL,51,9,11,20,20,-7
Jack St. Ivany,2016-17,Sioux Falls Stampede,USHL,52,1,9,10,14,-12
Jack St. Ivany,2017-18,Sioux Falls Stampede,USHL,54,6,30,36,30,2
Jack St. Ivany,2018-19,Yale University,ECAC,30,6,8,14,20,8
Jack St. Ivany,2019-20,Yale University,ECAC,32,1,15,16,18,-10
Jack St. Ivany,2020-21,Boston College,H-East,18,1,5,6,6,-1
Jack St. Ivany,2021-22,Boston College,H-East,35,4,20,24,6,8
Jack St. Ivany,2022-23,Wilkes-Barre/Scranton Penguins,AHL,63,0,8,8,33,-17
Jack St. Ivany,2023-24,Wilkes-Barre/Scranton Penguins,AHL,54,4,11,15,30,17
Jack St. Ivany,2023-24,Pittsburgh Penguins,NHL,14,0,1,1,2,
Jack St. Ivany,2024-25,Pittsburgh Penguins*,NHL,19,0,1,1,17,-3
Jack St. Ivany,2024-25,Wilkes-Barre/Scranton Penguins,AHL,15,1,3,4,6,2
Curtis Lazar,2010-11,Edmonton Oil Kings,WHL,6,0,1,1,0,2
Curtis Lazar,2011-12,Edmonton Oil Kings üèÜ,WHL,63,20,11,31,56,15
Curtis Lazar,2012-13,Edmonton Oil Kings,WHL,72,38,23,61,47,25
Curtis Lazar,2013-14,Edmonton Oil Kings üèÜ,WHL,58,41,35,76,30,41
Curtis Lazar,2014-15,Ottawa Senators,NHL,67,6,9,15,14,1
Curtis Lazar,2015-16,Ottawa Senators,NHL,76,6,14,20,18,-1
Curtis Lazar,2016-17,Binghamton Senators,AHL,13,3,1,4,8,-1
Curtis Lazar,2016-17,Ottawa Senators,NHL,33,0,1,1,4,-10
Curtis Lazar,2016-17,Calgary Flames,NHL,4,1,2,3,0,2
Curtis Lazar,2017-18,Calgary Flames,NHL,65,2,10,12,23,-8
Curtis Lazar,2018-19,Calgary Flames,NHL,1,0,0,0,0,-1
Curtis Lazar,2018-19,Stockton Heat,AHL,57,20,21,41,47,-9
Curtis Lazar,2019-20,Rochester Americans,AHL,18,6,8,14,6,10
Curtis Lazar,2019-20,Buffalo Sabres,NHL,38,5,5,10,9,-3
Curtis Lazar,2020-21,Buffalo Sabres,NHL,33,5,4,9,0,-4
Curtis Lazar,2020-21,Boston Bruins,NHL,17,2,2,4,6,-2
Curtis Lazar,2021-22,Boston Bruins,NHL,70,8,8,16,16,-2
Curtis Lazar,2022-23,Vancouver Canucks,NHL,45,3,2,5,14,-5
Curtis Lazar,2022-23,New Jersey Devils,NHL,4,0,0,0,7,-1
Curtis Lazar,2023-24,New Jersey Devils,NHL,71,7,18,25,44,10
Curtis Lazar,2024-25,New Jersey Devils,NHL,32,1,3,4,12,1
Aliaksei Protas,2018-19,Prince Albert Raiders üèÜ,WHL,61,11,29,40,4,24
Aliaksei Protas,2019-20,Prince Albert Raiders,WHL,58,31,49,80,8,37
Aliaksei Protas,2020-21,Minsk Dynamo,KHL,58,10,8,18,4,0
Aliaksei Protas,2020-21,Hershey Bears,AHL,16,2,5,7,2,1
Aliaksei Protas,2021-22,Hershey Bears,AHL,42,8,16,24,10,-3
Aliaksei Protas,2021-22,Washington Capitals,NHL,33,3,6,9,0,4
Aliaksei Protas,2022-23,Washington Capitals,NHL,58,4,11,15,12,-8
Aliaksei Protas,2022-23,Hershey Bears üèÜ,AHL,9,2,3,5,0,-4
Aliaksei Protas,2023-24,Washington Capitals,NHL,78,6,23,29,8,-3
Aliaksei Protas,2024-25,Washington Capitals,NHL,55,22,24,46,16,29
Nikolaj Ehlers,2012-13,Biel HC,Swiss-A,11,1,1,2,0,1
Nikolaj Ehlers,2013-14,Halifax Mooseheads,QMJHL,63,49,55,104,51,65
Nikolaj Ehlers,2014-15,Halifax Mooseheads,QMJHL,51,37,64,101,67,26
Nikolaj Ehlers,2015-16,Winnipeg Jets,NHL,72,15,23,38,21,3
Nikolaj Ehlers,2016-17,Winnipeg Jets,NHL,82,25,39,64,38,1
Nikolaj Ehlers,2017-18,Winnipeg Jets,NHL,82,29,31,60,26,14
Nikolaj Ehlers,2018-19,Winnipeg Jets,NHL,62,21,16,37,15,2
Nikolaj Ehlers,2019-20,Winnipeg Jets,NHL,71,25,33,58,30,14
Nikolaj Ehlers,2020-21,Winnipeg Jets,NHL,47,21,25,46,15,15
Nikolaj Ehlers,2021-22,Winnipeg Jets,NHL,62,28,27,55,20,18
Nikolaj Ehlers,2022-23,Winnipeg Jets,NHL,45,12,26,38,11,-2
Nikolaj Ehlers,2023-24,Winnipeg Jets,NHL,82,25,36,61,29,27
Nikolaj Ehlers,2024-25,Winnipeg Jets,NHL,47,17,31,48,6,12
Adam Klapka,2019-20,Tri-City Storm,USHL,8,3,1,4,22,4
Adam Klapka,2020-21,Tri-City Storm,USHL,49,12,9,21,73,8
Adam Klapka,2021-22,Liberec Bili Tygri HC,Czech,44,6,12,18,72,-1
Adam Klapka,2022-23,Calgary Wranglers,AHL,60,13,12,25,80,1
Adam Klapka,2023-24,Calgary Flames,NHL,6,1,0,1,19,-1
Adam Klapka,2023-24,Calgary Wranglers,AHL,65,21,25,46,90,8
Adam Klapka,2024-25,Calgary Wranglers*,AHL,31,13,12,25,50,1
Adam Klapka,2024-25,Calgary Flames,NHL,12,1,0,1,15,1
Rickard Rakell,2009-10,AIK Jr.,Swe-Jr,8,3,1,4,2,-3
Rickard Rakell,2010-11,Plymouth Whalers,OHL,49,19,24,43,12,14
Rickard Rakell,2011-12,Plymouth Whalers,OHL,60,28,34,62,12,9
Rickard Rakell,2012-13,Plymouth Whalers,OHL,40,21,23,44,12,19
Rickard Rakell,2012-13,Anaheim Ducks,NHL,4,0,0,0,0,-2
Rickard Rakell,2013-14,Norfolk Admirals,AHL,46,14,23,37,12,7
Rickard Rakell,2013-14,Anaheim Ducks,NHL,18,0,4,4,2,-3
Rickard Rakell,2014-15,Anaheim Ducks,NHL,71,9,22,31,10,6
Rickard Rakell,2014-15,Norfolk Admirals,AHL,2,1,3,4,0,3
Rickard Rakell,2015-16,Anaheim Ducks,NHL,72,20,23,43,19,-1
Rickard Rakell,2016-17,Anaheim Ducks,NHL,71,33,18,51,12,10
Rickard Rakell,2017-18,Anaheim Ducks,NHL,77,34,35,69,14,6
Rickard Rakell,2018-19,Anaheim Ducks,NHL,69,18,25,43,27,-13
Rickard Rakell,2019-20,Anaheim Ducks,NHL,65,15,27,42,12,-5
Rickard Rakell,2020-21,Anaheim Ducks,NHL,52,9,19,28,12,-14
Rickard Rakell,2021-22,Anaheim Ducks,NHL,51,16,12,28,8,-7
Rickard Rakell,2021-22,Pittsburgh Penguins,NHL,19,4,9,13,4,7
Rickard Rakell,2022-23,Pittsburgh Penguins,NHL,82,28,32,60,16,-5
Rickard Rakell,2023-24,Pittsburgh Penguins,NHL,70,15,22,37,22,4
Rickard Rakell,2024-25,Pittsburgh Penguins,NHL,56,25,23,48,10,-14
Kevin Gravel,2008-09,Marquette Rangers,NAHL,58,3,11,14,29,2
Kevin Gravel,2009-10,Sioux City Musketeers,USHL,53,3,3,6,36,-8
Kevin Gravel,2010-11,St. Cloud State,WCHA,36,1,5,6,4,
Kevin Gravel,2011-12,St. Cloud State,WCHA,37,1,7,8,12,
Kevin Gravel,2012-13,St. Cloud State,WCHA,42,1,11,12,25,
Kevin Gravel,2013-14,St. Cloud State,NCHC,38,10,13,23,2,
Kevin Gravel,2013-14,Manchester Monarchs,AHL,5,0,0,0,2,-3
Kevin Gravel,2014-15,Manchester Monarchs üèÜ,AHL,58,6,9,15,23,15
Kevin Gravel,2015-16,Ontario Reign,AHL,55,7,13,20,30,4
Kevin Gravel,2015-16,Los Angeles Kings,NHL,5,0,0,0,0,0
Kevin Gravel,2016-17,Ontario Reign,AHL,6,0,2,2,0,-2
Kevin Gravel,2016-17,Los Angeles Kings,NHL,49,1,6,7,6,3
Kevin Gravel,2017-18,Ontario Reign,AHL,25,3,8,11,17,-3
Kevin Gravel,2017-18,Los Angeles Kings,NHL,16,0,3,3,2,-3
Kevin Gravel,2018-19,Bakersfield Condors,AHL,5,0,1,1,0,1
Kevin Gravel,2018-19,Edmonton Oilers,NHL,36,0,3,3,4,-2
Kevin Gravel,2019-20,Toronto Marlies,AHL,23,1,2,3,8,4
Kevin Gravel,2019-20,Toronto Maple Leafs,NHL,3,0,0,0,0,0
Kevin Gravel,2020-21,Bakersfield Condors üèÜ,AHL,37,1,7,8,17,0
Kevin Gravel,2021-22,Stockton Heat,AHL,59,3,11,14,11,12
Kevin Gravel,2022-23,Nashville Predators,NHL,23,0,1,1,4,-10
Kevin Gravel,2022-23,Milwaukee Admirals,AHL,49,2,11,13,16,7
Kevin Gravel,2023-24,Milwaukee Admirals,AHL,63,1,9,10,18,2
Kevin Gravel,2024-25,Nashville Predators*,NHL,6,0,1,1,0,3
Kevin Gravel,2024-25,Milwaukee Admirals,AHL,41,4,11,15,27,0
Pavel Buchnevich,2011-12,Cherepovets Almaz,Rus-MHL,45,15,29,44,55,15
Pavel Buchnevich,2012-13,Cherepovets Severstal,KHL,12,1,1,2,0,-2
Pavel Buchnevich,2012-13,Cherepovets Almaz,Rus-MHL,24,8,15,23,20,-2
Pavel Buchnevich,2013-14,Cherepovets Severstal,KHL,40,7,11,18,12,-1
Pavel Buchnevich,2013-14,Cherepovets Almaz,Rus-MHL,2,0,2,2,4,4
Pavel Buchnevich,2014-15,Cherepovets Severstal,KHL,48,13,17,30,16,8
Pavel Buchnevich,2015-16,Cherepovets Severstal,KHL,40,12,17,29,20,-6
Pavel Buchnevich,2015-16,St. Petersburg SKA,KHL,18,4,4,8,4,0
Pavel Buchnevich,2016-17,New York Rangers,NHL,41,8,12,20,13,6
Pavel Buchnevich,2016-17,Hartford Wolf Pack,AHL,4,3,2,5,0,2
Pavel Buchnevich,2017-18,New York Rangers,NHL,74,14,29,43,20,-3
Pavel Buchnevich,2018-19,New York Rangers,NHL,64,21,17,38,13,-10
Pavel Buchnevich,2019-20,New York Rangers,NHL,68,16,30,46,24,2
Pavel Buchnevich,2020-21,New York Rangers,NHL,54,20,28,48,42,12
Pavel Buchnevich,2021-22,St. Louis Blues,NHL,73,30,46,76,34,29
Pavel Buchnevich,2022-23,St. Louis Blues,NHL,63,26,41,67,36,14
Pavel Buchnevich,2023-24,St. Louis Blues,NHL,80,27,36,63,48,3
Pavel Buchnevich,2024-25,St. Louis Blues,NHL,54,11,23,34,15,-2
Nick Suzuki,2014-15,London Nationals,GOJHL,1,0,1,1,0,
Nick Suzuki,2015-16,Owen Sound Attack,OHL,63,20,18,38,4,-15
Nick Suzuki,2016-17,Owen Sound Attack,OHL,65,45,51,96,10,51
Nick Suzuki,2017-18,Owen Sound Attack,OHL,64,42,58,100,18,30
Nick Suzuki,2017-18,Chicago Wolves,AHL,--,--,--,--,--,--
Nick Suzuki,2018-19,Owen Sound Attack,OHL,30,22,23,45,4,12
Nick Suzuki,2018-19,Guelph Storm üèÜ,OHL,29,12,37,49,8,28
Nick Suzuki,2019-20,Montreal Canadiens,NHL,71,13,28,41,6,-15
Nick Suzuki,2020-21,Montreal Canadiens,NHL,56,15,26,41,26,-5
Nick Suzuki,2021-22,Montreal Canadiens,NHL,82,21,40,61,30,-29
Nick Suzuki,2022-23,Montreal Canadiens,NHL,82,26,40,66,33,-13
Nick Suzuki,2023-24,Montreal Canadiens,NHL,82,33,44,77,36,-14
Nick Suzuki,2024-25,Montreal Canadiens,NHL,56,15,37,52,6,3
Adam Pelech,2010-11,Erie Otters,OHL,65,1,12,13,27,14
Adam Pelech,2011-12,Erie Otters,OHL,44,2,18,20,52,-20
Adam Pelech,2012-13,Erie Otters,OHL,59,8,32,40,98,-16
Adam Pelech,2013-14,Erie Otters,OHL,60,9,45,54,46,52
Adam Pelech,2014-15,Bridgeport Sound Tigers,AHL,65,0,11,11,48,-2
Adam Pelech,2015-16,Bridgeport Sound Tigers,AHL,27,2,5,7,6,3
Adam Pelech,2015-16,New York Islanders,NHL,9,0,2,2,0,-1
Adam Pelech,2016-17,Bridgeport Sound Tigers,AHL,13,1,4,5,10,0
Adam Pelech,2016-17,New York Islanders,NHL,44,3,7,10,6,-5
Adam Pelech,2017-18,New York Islanders,NHL,78,3,16,19,28,7
Adam Pelech,2018-19,New York Islanders,NHL,78,5,16,21,24,22
Adam Pelech,2019-20,New York Islanders,NHL,38,1,8,9,20,4
Adam Pelech,2020-21,New York Islanders,NHL,56,4,10,14,18,15
Adam Pelech,2021-22,New York Islanders,NHL,78,3,25,28,42,20
Adam Pelech,2022-23,New York Islanders,NHL,61,6,15,21,36,15
Adam Pelech,2023-24,New York Islanders,NHL,58,1,15,16,27,-2
Adam Pelech,2024-25,New York Islanders,NHL,35,0,14,14,14,4
Mathew Dumba,2009-10,Red Deer Rebels,WHL,6,0,2,2,4,-1
Mathew Dumba,2010-11,Red Deer Rebels,WHL,62,15,11,26,83,23
Mathew Dumba,2011-12,Red Deer Rebels,WHL,69,20,37,57,67,-6
Mathew Dumba,2012-13,Red Deer Rebels,WHL,62,16,26,42,80,10
Mathew Dumba,2012-13,Houston Aeros,AHL,3,0,0,0,2,0
Mathew Dumba,2013-14,Minnesota Wild,NHL,13,1,1,2,2,-5
Mathew Dumba,2013-14,Portland Winterhawks,WHL,26,8,16,24,37,31
Mathew Dumba,2014-15,Minnesota Wild,NHL,58,8,8,16,23,13
Mathew Dumba,2014-15,Iowa Wild,AHL,20,5,9,14,6,2
Mathew Dumba,2015-16,Minnesota Wild,NHL,81,10,16,26,38,1
Mathew Dumba,2016-17,Minnesota Wild,NHL,76,11,23,34,59,15
Mathew Dumba,2017-18,Minnesota Wild,NHL,82,14,36,50,41,15
Mathew Dumba,2018-19,Minnesota Wild,NHL,32,12,10,22,21,-5
Mathew Dumba,2019-20,Minnesota Wild,NHL,69,6,18,24,41,-7
Mathew Dumba,2020-21,Minnesota Wild,NHL,51,6,15,21,46,1
Mathew Dumba,2021-22,Minnesota Wild,NHL,57,7,20,27,47,9
Mathew Dumba,2022-23,Minnesota Wild,NHL,79,4,10,14,81,-8
Mathew Dumba,2023-24,Arizona Coyotes,NHL,58,4,6,10,55,-13
Mathew Dumba,2023-24,Tampa Bay Lightning,NHL,18,0,2,2,33,-5
Mathew Dumba,2024-25,Dallas Stars,NHL,36,0,4,4,35,-2
Parker Ford,2017-18,Sioux City Musketeers,USHL,51,8,14,22,36,-12
Parker Ford,2018-19,Sioux City Musketeers,USHL,56,19,24,43,40,5
Parker Ford,2019-20,Providence College,H-East,31,9,13,22,22,14
Parker Ford,2020-21,Providence College,H-East,25,7,12,19,14,1
Parker Ford,2021-22,Providence College,H-East,38,13,14,27,31,6
Parker Ford,2022-23,Providence College,H-East,37,12,14,26,22,18
Parker Ford,2022-23,Manitoba Moose,AHL,8,2,2,4,4,3
Parker Ford,2023-24,Manitoba Moose,AHL,72,18,23,41,57,-9
Parker Ford,2024-25,Winnipeg Jets*,NHL,--,Statistics Unavailable,,,,
Parker Ford,2024-25,Manitoba Moose,AHL,41,14,7,21,36,-3
William Carrier,2010-11,Cape Breton Screaming Eagles,QMJHL,61,8,4,12,54,-28
William Carrier,2011-12,Cape Breton Screaming Eagles,QMJHL,66,27,43,70,65,-10
William Carrier,2012-13,Cape Breton Screaming Eagles,QMJHL,34,16,26,42,41,-14
William Carrier,2013-14,Cape Breton Screaming Eagles,QMJHL,39,12,29,41,42,-3
William Carrier,2013-14,Drummondville Voltigeurs,QMJHL,27,10,14,24,45,2
William Carrier,2014-15,Rochester Americans,AHL,63,7,14,21,38,1
William Carrier,2015-16,Rochester Americans,AHL,56,13,17,30,48,14
William Carrier,2016-17,Rochester Americans,AHL,8,3,2,5,6,-1
William Carrier,2016-17,Buffalo Sabres,NHL,41,5,3,8,21,-1
William Carrier,2017-18,Vegas Golden Knights,NHL,37,1,2,3,19,-3
William Carrier,2018-19,Vegas Golden Knights,NHL,54,8,1,9,29,-4
William Carrier,2019-20,Vegas Golden Knights,NHL,71,7,12,19,39,0
William Carrier,2020-21,Vegas Golden Knights,NHL,52,6,9,15,16,0
William Carrier,2021-22,Vegas Golden Knights,NHL,63,9,11,20,34,7
William Carrier,2022-23,Vegas Golden Knights üèÜ,NHL,56,16,9,25,30,15
William Carrier,2023-24,Vegas Golden Knights,NHL,39,6,2,8,16,3
William Carrier,2024-25,Carolina Hurricanes,NHL,39,4,5,9,16,2
Jason Robertson,2015-16,Kingston Frontenacs,OHL,54,18,14,32,6,5
Jason Robertson,2016-17,Kingston Frontenacs,OHL,68,42,39,81,29,3
Jason Robertson,2017-18,Kingston Frontenacs,OHL,68,41,46,87,36,8
Jason Robertson,2018-19,Kingston Frontenacs,OHL,24,23,15,38,18,1
Jason Robertson,2018-19,Niagara IceDogs,OHL,38,25,54,79,24,36
Jason Robertson,2019-20,Texas Stars,AHL,60,25,22,47,28,-6
Jason Robertson,2019-20,Dallas Stars,NHL,3,0,1,1,0,0
Jason Robertson,2020-21,Dallas Stars,NHL,51,17,28,45,16,13
Jason Robertson,2021-22,Dallas Stars,NHL,74,41,38,79,22,16
Jason Robertson,2022-23,Dallas Stars,NHL,82,46,63,109,20,37
Jason Robertson,2023-24,Dallas Stars,NHL,82,29,51,80,22,19
Jason Robertson,2024-25,Dallas Stars,NHL,55,20,31,51,10,4
Owen Pickering,2020-21,Swift Current Broncos,WHL,23,2,7,9,8,-3
Owen Pickering,2021-22,Swift Current Broncos,WHL,62,9,24,33,39,-29
Owen Pickering,2022-23,Wilkes-Barre/Scranton Penguins,AHL,8,0,0,0,0,-9
Owen Pickering,2022-23,Swift Current Broncos,WHL,61,9,36,45,30,-5
Owen Pickering,2023-24,Swift Current Broncos,WHL,59,7,39,46,35,18
Owen Pickering,2024-25,Pittsburgh Penguins*,NHL,25,1,2,3,6,-5
Owen Pickering,2024-25,Wilkes-Barre/Scranton Penguins,AHL,23,2,3,5,8,18
Jared McCann,2011-12,London Nationals,GOJHL,4,1,0,1,2,
Jared McCann,2012-13,Soo Greyhounds,OHL,64,21,23,44,35,-6
Jared McCann,2013-14,Soo Greyhounds,OHL,64,27,35,62,51,9
Jared McCann,2014-15,Soo Greyhounds,OHL,56,34,47,81,27,30
Jared McCann,2015-16,Vancouver Canucks,NHL,69,9,9,18,32,-6
Jared McCann,2016-17,Florida Panthers,NHL,29,1,6,7,4,-1
Jared McCann,2016-17,Springfield Thunderbirds,AHL,42,11,14,25,55,5
Jared McCann,2017-18,Florida Panthers,NHL,68,9,19,28,30,11
Jared McCann,2018-19,Florida Panthers,NHL,46,8,10,18,18,-9
Jared McCann,2018-19,Pittsburgh Penguins,NHL,32,11,6,17,13,8
Jared McCann,2019-20,Pittsburgh Penguins,NHL,66,14,21,35,17,6
Jared McCann,2020-21,Pittsburgh Penguins,NHL,43,14,18,32,8,17
Jared McCann,2021-22,Seattle Kraken,NHL,74,27,23,50,33,-26
Jared McCann,2022-23,Seattle Kraken,NHL,79,40,30,70,14,18
Jared McCann,2023-24,Seattle Kraken,NHL,80,29,33,62,31,-10
Jared McCann,2024-25,Seattle Kraken,NHL,57,14,28,42,14,7
Andrei Kuzmenko,2012-13,CSKA Red Army Jr.,Rus-MHL,49,5,7,12,16,0
Andrei Kuzmenko,2013-14,CSKA Red Army Jr.,Rus-MHL,36,13,18,31,33,17
Andrei Kuzmenko,2014-15,CSKA Red Army Jr.,Rus-MHL,37,20,21,41,28,8
Andrei Kuzmenko,2014-15,CSKA Moscow,KHL,12,1,2,3,0,6
Andrei Kuzmenko,2015-16,Moscow Zvezda HC,Rus-VHL,17,2,4,6,2,-4
Andrei Kuzmenko,2015-16,CSKA Moscow,KHL,15,1,2,3,0,5
Andrei Kuzmenko,2015-16,CSKA Red Army Jr.,Rus-MHL,5,1,3,4,5,3
Andrei Kuzmenko,2016-17,CSKA Moscow,KHL,34,6,9,15,6,11
Andrei Kuzmenko,2016-17,CSKA Red Army Jr.,Rus-MHL,3,3,0,3,2,-1
Andrei Kuzmenko,2016-17,Dmitrov Zvezda VDV,Rus-VHL,23,11,17,28,4,19
Andrei Kuzmenko,2017-18,CSKA Moscow,KHL,45,13,12,25,12,21
Andrei Kuzmenko,2017-18,Dmitrov Zvezda VDV,Rus-VHL,7,5,5,10,2,7
Andrei Kuzmenko,2018-19,St. Petersburg SKA,KHL,58,12,19,31,20,23
Andrei Kuzmenko,2019-20,St. Petersburg SKA,KHL,49,14,19,33,6,20
Andrei Kuzmenko,2020-21,St. Petersburg SKA,KHL,57,18,19,37,14,17
Andrei Kuzmenko,2021-22,St. Petersburg SKA,KHL,45,20,33,53,10,15
Andrei Kuzmenko,2022-23,Vancouver Canucks,NHL,81,39,35,74,8,9
Andrei Kuzmenko,2023-24,Vancouver Canucks,NHL,43,8,13,21,6,-1
Andrei Kuzmenko,2023-24,Calgary Flames,NHL,29,14,11,25,6,-8
Andrei Kuzmenko,2024-25,Calgary Flames*,NHL,37,4,11,15,12,-7
Andrei Kuzmenko,2024-25,Philadelphia Flyers,NHL,2,1,1,2,0,-2
Troy Terry,2013-14,Indiana Ice,USHL,1,0,0,0,0,0
Troy Terry,2014-15,U.S. National Under-18 Team,USHL,25,6,8,14,4,3
Troy Terry,2015-16,U. of Denver,NCHC,41,9,13,22,8,4
Troy Terry,2016-17,U. of Denver,NCHC,35,22,23,45,22,31
Troy Terry,2017-18,U. of Denver,NCHC,39,14,34,48,6,21
Troy Terry,2017-18,Anaheim Ducks,NHL,2,0,0,0,0,0
Troy Terry,2018-19,Anaheim Ducks,NHL,32,4,9,13,2,8
Troy Terry,2018-19,San Diego Gulls,AHL,41,16,25,41,4,1
Troy Terry,2019-20,Anaheim Ducks,NHL,47,4,11,15,6,-5
Troy Terry,2019-20,San Diego Gulls,AHL,14,7,9,16,6,14
Troy Terry,2020-21,Anaheim Ducks,NHL,48,7,13,20,18,-1
Troy Terry,2021-22,Anaheim Ducks,NHL,75,37,30,67,26,-11
Troy Terry,2022-23,Anaheim Ducks,NHL,70,23,38,61,22,-8
Troy Terry,2023-24,Anaheim Ducks,NHL,76,20,34,54,24,-10
Troy Terry,2024-25,Anaheim Ducks,NHL,49,16,23,39,14,1
Anthony Beauvillier,2013-14,Shawinigan Cataractes,QMJHL,64,9,24,33,26,-27
Anthony Beauvillier,2014-15,Shawinigan Cataractes,QMJHL,67,42,52,94,72,16
Anthony Beauvillier,2015-16,Shawinigan Cataractes,QMJHL,47,40,39,79,57,21
Anthony Beauvillier,2016-17,New York Islanders,NHL,66,9,15,24,10,1
Anthony Beauvillier,2017-18,New York Islanders,NHL,71,21,15,36,16,2
Anthony Beauvillier,2017-18,Bridgeport Sound Tigers,AHL,3,2,0,2,0,2
Anthony Beauvillier,2018-19,New York Islanders,NHL,81,18,10,28,8,1
Anthony Beauvillier,2019-20,New York Islanders,NHL,68,18,21,39,15,-11
Anthony Beauvillier,2020-21,New York Islanders,NHL,47,15,13,28,12,15
Anthony Beauvillier,2021-22,New York Islanders,NHL,75,12,22,34,12,-10
Anthony Beauvillier,2022-23,New York Islanders,NHL,49,9,11,20,10,-4
Anthony Beauvillier,2022-23,Vancouver Canucks,NHL,33,9,11,20,14,-6
Anthony Beauvillier,2023-24,Vancouver Canucks,NHL,22,2,6,8,4,8
Anthony Beauvillier,2023-24,Chicago Blackhawks,NHL,23,2,4,6,2,-10
Anthony Beauvillier,2023-24,Nashville Predators,NHL,15,1,2,3,2,-6
Anthony Beauvillier,2024-25,Pittsburgh Penguins,NHL,57,12,6,18,10,2
Jett Luchanko,2021-22,Strathroy Rockets,GOJHL,4,1,1,2,0,
Jett Luchanko,2022-23,Guelph Storm,OHL,46,5,9,14,10,-5
Jett Luchanko,2023-24,Guelph Storm,OHL,68,20,54,74,36,-13
Jett Luchanko,2024-25,Philadelphia Flyers*,NHL,4,0,0,0,2,-3
Jett Luchanko,2024-25,Guelph Storm,OHL,31,15,27,42,29,-2
Elmer Soderblom,2017-18,Vastra Frolunda Jr.,Swe-Jr,3,0,0,0,0,-1
Elmer Soderblom,2018-19,Vastra Frolunda Jr.,Swe-Jr,44,9,8,17,12,1
Elmer Soderblom,2019-20,Vastra Frolunda Jr.,Swe-Jr,36,29,26,55,10,22
Elmer Soderblom,2019-20,Frolunda HC,SweHL,10,0,0,0,2,-2
Elmer Soderblom,2019-20,Tingsryds AIF,Swe-1,5,0,0,0,4,-4
Elmer Soderblom,2020-21,Vastra Frolunda Jr.,Swe-Jr,4,2,2,4,0,0
Elmer Soderblom,2020-21,Frolunda HC,SweHL,28,3,2,5,2,-1
Elmer Soderblom,2021-22,Frolunda HC,SweHL,52,21,12,33,10,-10
Elmer Soderblom,2022-23,Detroit Red Wings,NHL,21,5,3,8,8,0
Elmer Soderblom,2022-23,Grand Rapids Griffins,AHL,20,5,3,8,10,-3
Elmer Soderblom,2023-24,Grand Rapids Griffins,AHL,61,13,16,29,8,1
Elmer Soderblom,2024-25,Grand Rapids Griffins*,AHL,38,5,12,17,29,4
Elmer Soderblom,2024-25,Detroit Red Wings,NHL,10,2,3,5,0,1
Carter Verhaeghe,2011-12,Niagara IceDogs,OHL,62,4,12,16,10,6
Carter Verhaeghe,2012-13,Niagara IceDogs,OHL,67,18,26,44,22,-12
Carter Verhaeghe,2013-14,Niagara IceDogs,OHL,65,28,54,82,60,-19
Carter Verhaeghe,2013-14,Toronto Marlies,AHL,2,0,1,1,0,2
Carter Verhaeghe,2014-15,Niagara IceDogs,OHL,68,33,49,82,38,21
Carter Verhaeghe,2015-16,Bridgeport Sound Tigers,AHL,30,6,9,15,6,3
Carter Verhaeghe,2015-16,Missouri Mavericks,ECHL,20,8,17,25,2,16
Carter Verhaeghe,2016-17,Bridgeport Sound Tigers,AHL,45,16,13,29,20,12
Carter Verhaeghe,2016-17,Missouri Mavericks,ECHL,16,12,20,32,4,11
Carter Verhaeghe,2017-18,Syracuse Crunch,AHL,58,17,31,48,30,18
Carter Verhaeghe,2018-19,Syracuse Crunch,AHL,76,34,48,82,34,26
Carter Verhaeghe,2019-20,Tampa Bay Lightning üèÜ,NHL,52,9,4,13,8,-9
Carter Verhaeghe,2020-21,Florida Panthers,NHL,43,18,18,36,31,24
Carter Verhaeghe,2021-22,Florida Panthers,NHL,78,24,31,55,48,24
Carter Verhaeghe,2022-23,Florida Panthers,NHL,81,42,31,73,46,10
Carter Verhaeghe,2023-24,Florida Panthers üèÜ,NHL,76,34,38,72,36,17
Carter Verhaeghe,2024-25,Florida Panthers,NHL,57,15,28,43,32,-13
Alex Steeves,2015-16,New Hampshire Jr. Monarchs,EHL,4,2,4,6,0,
Alex Steeves,2015-16,Sioux City Musketeers,USHL,39,5,6,11,16,-14
Alex Steeves,2016-17,Dubuque Fighting Saints,USHL,53,6,12,18,33,-3
Alex Steeves,2017-18,Dubuque Fighting Saints,USHL,55,20,37,57,28,4
Alex Steeves,2018-19,Notre Dame,Big-10,39,7,2,9,10,-1
Alex Steeves,2019-20,Notre Dame,Big-10,36,11,17,28,10,6
Alex Steeves,2020-21,Notre Dame,Big-10,29,15,17,32,8,2
Alex Steeves,2021-22,Toronto Maple Leafs,NHL,3,0,1,1,0,-1
Alex Steeves,2021-22,Toronto Marlies,AHL,58,23,23,46,37,0
Alex Steeves,2022-23,Toronto Maple Leafs,NHL,3,0,0,0,0,-2
Alex Steeves,2022-23,Toronto Marlies,AHL,65,19,32,51,28,-11
Alex Steeves,2023-24,Toronto Maple Leafs,NHL,1,0,0,0,0,-1
Alex Steeves,2023-24,Toronto Marlies,AHL,65,27,30,57,26,
Alex Steeves,2024-25,Toronto Marlies*,AHL,40,29,17,46,28,9
Alex Steeves,2024-25,Toronto Maple Leafs,NHL,4,0,0,0,0,0
Luke Evangelista,2018-19,London Knights,OHL,27,0,2,2,4,-5
Luke Evangelista,2019-20,London Knights,OHL,62,23,38,61,12,15
Luke Evangelista,2020-21,Chicago Wolves,AHL,14,0,4,4,4,-1
Luke Evangelista,2021-22,London Knights,OHL,62,55,56,111,48,29
Luke Evangelista,2022-23,Milwaukee Admirals,AHL,49,9,32,41,18,10
Luke Evangelista,2022-23,Nashville Predators,NHL,24,7,8,15,6,7
Luke Evangelista,2023-24,Nashville Predators,NHL,80,16,23,39,18,
Luke Evangelista,2024-25,Nashville Predators,NHL,41,5,10,15,16,-1
James van Riemsdyk,2005-06,USNTDP Under-18 Team,NAHL,37,18,11,29,26,
James van Riemsdyk,2006-07,USNTDP Under-18 Team,NAHL,12,13,12,25,37,
James van Riemsdyk,2007-08,U. of New Hampshire,H-East,31,11,23,34,36,
James van Riemsdyk,2008-09,U. of New Hampshire,H-East,36,17,23,40,47,
James van Riemsdyk,2008-09,Philadelphia Phantoms,AHL,7,1,1,2,2,2
James van Riemsdyk,2009-10,Philadelphia Flyers,NHL,78,15,20,35,30,-1
James van Riemsdyk,2010-11,Philadelphia Flyers,NHL,75,21,19,40,35,15
James van Riemsdyk,2011-12,Philadelphia Flyers,NHL,43,11,13,24,24,-1
James van Riemsdyk,2012-13,Toronto Maple Leafs,NHL,48,18,14,32,26,-7
James van Riemsdyk,2013-14,Toronto Maple Leafs,NHL,80,30,31,61,50,-9
James van Riemsdyk,2014-15,Toronto Maple Leafs,NHL,82,27,29,56,43,-33
James van Riemsdyk,2015-16,Toronto Maple Leafs,NHL,40,14,15,29,6,3
James van Riemsdyk,2016-17,Toronto Maple Leafs,NHL,82,29,33,62,37,-2
James van Riemsdyk,2017-18,Toronto Maple Leafs,NHL,81,36,18,54,30,1
James van Riemsdyk,2018-19,Philadelphia Flyers,NHL,66,27,21,48,18,-10
James van Riemsdyk,2019-20,Philadelphia Flyers,NHL,66,19,21,40,8,5
James van Riemsdyk,2020-21,Philadelphia Flyers,NHL,56,17,26,43,14,2
James van Riemsdyk,2021-22,Philadelphia Flyers,NHL,82,24,14,38,25,-33
James van Riemsdyk,2022-23,Philadelphia Flyers,NHL,61,12,17,29,28,-3
James van Riemsdyk,2023-24,Boston Bruins,NHL,71,11,27,38,20,7
James van Riemsdyk,2024-25,Columbus Blue Jackets,NHL,49,11,14,25,12,-5
Jonas Rondbjerg,2014-15,Rungsted Ishockey,Denmark,30,3,1,4,0,
Jonas Rondbjerg,2015-16,Rungsted Ishockey,Denmark,35,10,4,14,6,3
Jonas Rondbjerg,2016-17,Vaxjo Lakers Jr.,Swe-Jr,42,9,22,31,4,13
Jonas Rondbjerg,2016-17,Vaxjo HC,SweHL,5,0,0,0,0,0
Jonas Rondbjerg,2017-18,Vaxjo Lakers Jr.,Swe-Jr,1,0,0,0,0,0
Jonas Rondbjerg,2017-18,Vaxjo HC,SweHL,35,6,5,11,4,8
Jonas Rondbjerg,2017-18,Troja/Ljungby IF,Swe-1,5,1,0,1,2,-2
Jonas Rondbjerg,2018-19,Vaxjo HC,SweHL,45,2,4,6,6,-9
Jonas Rondbjerg,2019-20,Chicago Wolves,AHL,1,0,0,0,0,0
Jonas Rondbjerg,2020-21,Henderson Silver Knights,AHL,38,6,7,13,6,9
Jonas Rondbjerg,2020-21,Rungsted Ishockey,Denmark,5,0,2,2,0,
Jonas Rondbjerg,2021-22,Vegas Golden Knights,NHL,30,2,4,6,4,0
Jonas Rondbjerg,2021-22,Henderson Silver Knights,AHL,39,14,13,27,4,8
Jonas Rondbjerg,2022-23,Vegas Golden Knights,NHL,13,0,1,1,4,-5
Jonas Rondbjerg,2022-23,Henderson Silver Knights,AHL,54,12,16,28,10,1
Jonas Rondbjerg,2023-24,Vegas Golden Knights,NHL,20,1,2,3,0,2
Jonas Rondbjerg,2023-24,Henderson Silver Knights,AHL,48,9,16,25,10,-13
Jonas Rondbjerg,2024-25,Vegas Golden Knights*,NHL,11,0,0,0,0,-3
Jonas Rondbjerg,2024-25,Henderson Silver Knights*,AHL,36,8,10,18,12,-8
Corey Schueneman,2011-12,Muskegon Lumberjacks,USHL,1,0,0,0,0,0
Corey Schueneman,2012-13,Michigan Warriors,NAHL,35,5,9,14,24,3
Corey Schueneman,2012-13,Muskegon Lumberjacks,USHL,1,0,0,0,0,0
Corey Schueneman,2012-13,Des Moines Buccaneers,USHL,25,3,9,12,12,-12
Corey Schueneman,2013-14,Des Moines Buccaneers,USHL,60,3,19,22,26,-9
Corey Schueneman,2014-15,Des Moines Buccaneers,USHL,45,14,25,39,12,-3
Corey Schueneman,2014-15,Muskegon Lumberjacks,USHL,13,2,5,7,4,-2
Corey Schueneman,2015-16,Western Michigan University,NCHC,35,1,12,13,12,-15
Corey Schueneman,2016-17,Western Michigan University,NCHC,38,5,17,22,25,3
Corey Schueneman,2017-18,Western Michigan University,NCHC,34,5,21,26,18,-6
Corey Schueneman,2018-19,Western Michigan University,NCHC,37,3,18,21,8,11
Corey Schueneman,2018-19,Stockton Heat,AHL,6,1,0,1,2,-2
Corey Schueneman,2019-20,Stockton Heat,AHL,44,3,18,21,29,4
Corey Schueneman,2019-20,Kansas City Mavericks,ECHL,4,2,1,3,0,-2
Corey Schueneman,2020-21,Laval Rocket,AHL,36,3,9,12,6,2
Corey Schueneman,2021-22,Laval Rocket,AHL,32,4,7,11,12,1
Corey Schueneman,2021-22,Montreal Canadiens,NHL,24,2,4,6,8,-5
Corey Schueneman,2022-23,Montreal Canadiens,NHL,7,0,1,1,0,1
Corey Schueneman,2022-23,Laval Rocket,AHL,62,6,17,23,24,13
Corey Schueneman,2023-24,Colorado Eagles,AHL,64,4,18,22,24,2
Corey Schueneman,2024-25,St. Louis Blues*,NHL,4,0,0,0,0,0
Corey Schueneman,2024-25,Springfield Thunderbirds,AHL,40,3,11,14,18,13
Evgeni Malkin,2003-04,Magnitogorsk Metallurg,Russia,34,3,9,12,12,
Evgeni Malkin,2004-05,Magnitogorsk Metallurg,Russia,52,12,20,32,24,
Evgeni Malkin,2005-06,Magnitogorsk Metallurg,Russia,46,21,26,47,46,
Evgeni Malkin,2006-07,Pittsburgh Penguins,NHL,78,33,52,85,80,2
Evgeni Malkin,2007-08,Pittsburgh Penguins,NHL,82,47,59,106,78,16
Evgeni Malkin,2008-09,Pittsburgh Penguins üèÜ,NHL,82,35,78,113,80,17
Evgeni Malkin,2009-10,Pittsburgh Penguins,NHL,67,28,49,77,100,-6
Evgeni Malkin,2010-11,Pittsburgh Penguins,NHL,43,15,22,37,18,-4
Evgeni Malkin,2011-12,Pittsburgh Penguins,NHL,75,50,59,109,70,18
Evgeni Malkin,2012-13,Magnitogorsk Metallurg,KHL,37,23,42,65,58,23
Evgeni Malkin,2012-13,Pittsburgh Penguins,NHL,31,9,24,33,36,5
Evgeni Malkin,2013-14,Pittsburgh Penguins,NHL,60,23,49,72,62,10
Evgeni Malkin,2014-15,Pittsburgh Penguins,NHL,69,28,42,70,60,-2
Evgeni Malkin,2015-16,Pittsburgh Penguins üèÜ,NHL,57,27,31,58,65,1
Evgeni Malkin,2016-17,Pittsburgh Penguins üèÜ,NHL,62,33,39,72,77,18
Evgeni Malkin,2017-18,Pittsburgh Penguins,NHL,78,42,56,98,87,16
Evgeni Malkin,2018-19,Pittsburgh Penguins,NHL,68,21,51,72,89,-25
Evgeni Malkin,2019-20,Pittsburgh Penguins,NHL,55,25,49,74,58,7
Evgeni Malkin,2020-21,Pittsburgh Penguins,NHL,33,8,20,28,24,-4
Evgeni Malkin,2021-22,Pittsburgh Penguins,NHL,41,20,22,42,24,-10
Evgeni Malkin,2022-23,Pittsburgh Penguins,NHL,82,27,56,83,82,-12
Evgeni Malkin,2023-24,Pittsburgh Penguins,NHL,82,27,40,67,70,5
Evgeni Malkin,2024-25,Pittsburgh Penguins,NHL,48,9,26,35,26,-20
Connor Zary,2017-18,Kamloops Blazers,WHL,68,11,18,29,26,-2
Connor Zary,2018-19,Kamloops Blazers,WHL,63,24,43,67,55,18
Connor Zary,2019-20,Kamloops Blazers,WHL,57,38,48,86,51,30
Connor Zary,2020-21,Stockton Heat,AHL,9,3,4,7,4,2
Connor Zary,2020-21,Kamloops Blazers,WHL,15,6,18,24,35,9
Connor Zary,2021-22,Stockton Heat,AHL,53,13,12,25,36,-4
Connor Zary,2022-23,Calgary Wranglers,AHL,72,21,37,58,63,7
Connor Zary,2023-24,Calgary Flames,NHL,63,14,20,34,22,12
Connor Zary,2023-24,Calgary Wranglers,AHL,6,1,9,10,2,4
Connor Zary,2024-25,Calgary Flames*,NHL,40,10,12,22,10,-6
Mikko Rantanen,2012-13,TPS Turku,SM-liiga,15,2,1,3,4,-1
Mikko Rantanen,2013-14,TPS Turku,SM-liiga,37,5,4,9,10,-11
Mikko Rantanen,2014-15,TPS Turku,SM-liiga,56,9,19,28,22,-1
Mikko Rantanen,2015-16,Colorado Avalanche,NHL,9,0,0,0,2,-7
Mikko Rantanen,2015-16,San Antonio Rampage,AHL,52,24,36,60,42,20
Mikko Rantanen,2016-17,San Antonio Rampage,AHL,4,0,2,2,4,0
Mikko Rantanen,2016-17,Colorado Avalanche,NHL,75,20,18,38,22,-25
Mikko Rantanen,2017-18,Colorado Avalanche,NHL,81,29,55,84,34,0
Mikko Rantanen,2018-19,Colorado Avalanche,NHL,74,31,56,87,54,13
Mikko Rantanen,2019-20,Colorado Avalanche,NHL,42,19,22,41,14,-2
Mikko Rantanen,2020-21,Colorado Avalanche,NHL,52,30,36,66,34,30
Mikko Rantanen,2021-22,Colorado Avalanche üèÜ,NHL,75,36,56,92,56,35
Mikko Rantanen,2022-23,Colorado Avalanche,NHL,82,55,50,105,82,15
Mikko Rantanen,2023-24,Colorado Avalanche,NHL,80,42,62,104,50,19
Mikko Rantanen,2024-25,Colorado Avalanche*,NHL,49,25,39,64,28,12
Mikko Rantanen,2024-25,Carolina Hurricanes,NHL,6,1,1,2,4,1
Jonathan Marchessault,2007-08,Quebec Remparts,QMJHL,56,10,10,20,18,5
Jonathan Marchessault,2008-09,Quebec Remparts,QMJHL,62,18,35,53,75,31
Jonathan Marchessault,2009-10,Quebec Remparts,QMJHL,68,30,41,71,54,24
Jonathan Marchessault,2010-11,Quebec Remparts,QMJHL,68,40,55,95,41,33
Jonathan Marchessault,2011-12,Connecticut Whale,AHL,76,24,40,64,50,1
Jonathan Marchessault,2012-13,Springfield Falcons,AHL,74,21,46,67,65,20
Jonathan Marchessault,2012-13,Columbus Blue Jackets,NHL,2,0,0,0,0,-1
Jonathan Marchessault,2013-14,Springfield Falcons,AHL,56,14,27,41,51,-7
Jonathan Marchessault,2013-14,Syracuse Crunch,AHL,21,9,6,15,8,-3
Jonathan Marchessault,2014-15,Syracuse Crunch,AHL,68,24,43,67,38,7
Jonathan Marchessault,2014-15,Tampa Bay Lightning,NHL,2,1,0,1,0,1
Jonathan Marchessault,2015-16,Syracuse Crunch,AHL,11,6,3,9,6,3
Jonathan Marchessault,2015-16,Tampa Bay Lightning,NHL,45,7,11,18,17,-10
Jonathan Marchessault,2016-17,Florida Panthers,NHL,75,30,21,51,38,-21
Jonathan Marchessault,2017-18,Vegas Golden Knights,NHL,77,27,48,75,40,36
Jonathan Marchessault,2018-19,Vegas Golden Knights,NHL,82,25,34,59,52,2
Jonathan Marchessault,2019-20,Vegas Golden Knights,NHL,66,22,25,47,28,6
Jonathan Marchessault,2020-21,Vegas Golden Knights,NHL,55,18,26,44,39,19
Jonathan Marchessault,2021-22,Vegas Golden Knights,NHL,76,30,36,66,36,3
Jonathan Marchessault,2022-23,Vegas Golden Knights üèÜ,NHL,76,28,29,57,21,2
Jonathan Marchessault,2023-24,Vegas Golden Knights,NHL,82,42,27,69,40,-2
Jonathan Marchessault,2024-25,Nashville Predators,NHL,54,17,27,44,31,-14
Ilya Mikheyev,2012-13,Omskie Yastreby,Rus-MHL,52,13,18,31,38,28
Ilya Mikheyev,2013-14,Angarsk Yermak,Rus-VHL,3,0,2,2,0,1
Ilya Mikheyev,2013-14,Omskie Yastreby,Rus-MHL,56,34,37,71,61,37
Ilya Mikheyev,2014-15,Krasnoyarsk Sokol,Rus-VHL,49,7,9,16,8,1
Ilya Mikheyev,2014-15,Omsk Avangard,KHL,--,--,--,--,--,--
Ilya Mikheyev,2015-16,Omsk Avangard,KHL,52,8,10,18,16,11
Ilya Mikheyev,2016-17,Omsk Avangard,KHL,56,12,7,19,10,3
Ilya Mikheyev,2017-18,Omsk Avangard,KHL,54,19,19,38,6,24
Ilya Mikheyev,2018-19,Omsk Avangard,KHL,62,23,22,45,8,21
Ilya Mikheyev,2019-20,Toronto Maple Leafs,NHL,39,8,15,23,4,7
Ilya Mikheyev,2020-21,Toronto Maple Leafs,NHL,54,7,10,17,6,5
Ilya Mikheyev,2021-22,Toronto Maple Leafs,NHL,53,21,11,32,26,16
Ilya Mikheyev,2022-23,Vancouver Canucks,NHL,46,13,15,28,2,3
Ilya Mikheyev,2023-24,Vancouver Canucks,NHL,78,11,20,31,4,1
Ilya Mikheyev,2024-25,Chicago Blackhawks,NHL,53,10,9,19,14,-2
Barclay Goodrow,2008-09,Villanova Knights,OJHL,2,2,1,3,2,
Barclay Goodrow,2009-10,Brampton Battalion,OHL,63,6,13,19,34,-3
Barclay Goodrow,2010-11,Brampton Battalion,OHL,65,24,15,39,36,-4
Barclay Goodrow,2011-12,Brampton Battalion,OHL,60,26,26,52,58,14
Barclay Goodrow,2012-13,Brampton Battalion,OHL,62,38,14,52,59,-2
Barclay Goodrow,2013-14,North Bay Battalion,OHL,63,33,34,67,64,18
Barclay Goodrow,2014-15,San Jose Sharks,NHL,60,4,8,12,35,-1
Barclay Goodrow,2014-15,Worcester Sharks,AHL,7,2,4,6,11,-1
Barclay Goodrow,2015-16,San Jose Sharks,NHL,14,0,3,3,16,1
Barclay Goodrow,2015-16,San Jose Barracuda,AHL,57,20,19,39,43,10
Barclay Goodrow,2016-17,San Jose Barracuda,AHL,61,25,20,45,55,16
Barclay Goodrow,2016-17,San Jose Sharks,NHL,3,0,1,1,0,0
Barclay Goodrow,2017-18,San Jose Sharks,NHL,47,7,7,14,28,1
Barclay Goodrow,2018-19,San Jose Sharks,NHL,82,7,10,17,76,4
Barclay Goodrow,2019-20,San Jose Sharks,NHL,62,8,16,24,80,-8
Barclay Goodrow,2019-20,Tampa Bay Lightning üèÜ,NHL,8,0,2,2,17,0
Barclay Goodrow,2020-21,Tampa Bay Lightning üèÜ,NHL,55,6,14,20,52,16
Barclay Goodrow,2021-22,New York Rangers,NHL,79,13,20,33,69,13
Barclay Goodrow,2022-23,New York Rangers,NHL,82,11,20,31,58,3
Barclay Goodrow,2023-24,New York Rangers,NHL,80,4,8,12,78,-13
Barclay Goodrow,2024-25,San Jose Sharks,NHL,52,4,3,7,45,-27
Luke Hughes,2019-20,U.S. National Under-17 Team,USHL,28,4,9,13,6,-14
Luke Hughes,2020-21,U.S. National Development Team,USHL,18,4,11,15,8,5
Luke Hughes,2021-22,U. of Michigan,Big-10,41,17,22,39,10,26
Luke Hughes,2022-23,U. of Michigan,Big-10,39,10,38,48,26,24
Luke Hughes,2022-23,New Jersey Devils,NHL,2,1,1,2,0,0
Luke Hughes,2023-24,New Jersey Devils,NHL,82,9,38,47,28,-25
Luke Hughes,2024-25,New Jersey Devils,NHL,48,5,17,22,10,-2
Gustav Nyquist,2006-07,Malmo Jr.,Swe-Jr,42,21,23,44,57,10
Gustav Nyquist,2007-08,Malmo Jr.,Swe-Jr,24,11,20,31,20,-9
Gustav Nyquist,2008-09,U. of Maine,H-East,38,13,19,32,28,
Gustav Nyquist,2009-10,U. of Maine,H-East,39,19,42,61,20,
Gustav Nyquist,2010-11,U. of Maine,H-East,36,18,33,51,20,
Gustav Nyquist,2010-11,Grand Rapids Griffins,AHL,8,1,3,4,2,1
Gustav Nyquist,2011-12,Grand Rapids Griffins,AHL,56,22,36,58,18,7
Gustav Nyquist,2011-12,Detroit Red Wings,NHL,18,1,6,7,2,2
Gustav Nyquist,2012-13,Grand Rapids Griffins üèÜ,AHL,58,23,37,60,34,10
Gustav Nyquist,2012-13,Detroit Red Wings,NHL,22,3,3,6,6,0
Gustav Nyquist,2013-14,Detroit Red Wings,NHL,57,28,20,48,10,16
Gustav Nyquist,2013-14,Grand Rapids Griffins,AHL,15,7,14,21,6,6
Gustav Nyquist,2014-15,Detroit Red Wings,NHL,82,27,27,54,26,-11
Gustav Nyquist,2015-16,Detroit Red Wings,NHL,82,17,26,43,34,-2
Gustav Nyquist,2016-17,Detroit Red Wings,NHL,76,12,36,48,18,0
Gustav Nyquist,2017-18,Detroit Red Wings,NHL,82,21,19,40,20,-2
Gustav Nyquist,2018-19,Detroit Red Wings,NHL,62,16,33,49,8,0
Gustav Nyquist,2018-19,San Jose Sharks,NHL,19,6,5,11,4,1
Gustav Nyquist,2019-20,Columbus Blue Jackets,NHL,70,15,27,42,16,4
Gustav Nyquist,2021-22,Columbus Blue Jackets,NHL,82,18,35,53,26,-12
Gustav Nyquist,2022-23,Columbus Blue Jackets,NHL,48,10,12,22,16,-11
Gustav Nyquist,2022-23,Minnesota Wild,NHL,3,1,4,5,0,2
Gustav Nyquist,2023-24,Nashville Predators,NHL,81,23,52,75,8,7
Gustav Nyquist,2024-25,Nashville Predators,NHL,53,9,11,20,10,-19
Fedor Svechkov,2019-20,Tolyatti Ladia,Rus-MHL,24,4,2,6,6,-9
Fedor Svechkov,2020-21,Tolyatti Lada,Rus-VHL,38,5,10,15,6,
Fedor Svechkov,2020-21,Tolyatti Ladia,Rus-MHL,15,4,11,15,35,5
Fedor Svechkov,2021-22,Neva SKA,Rus-VHL,30,9,22,31,12,13
Fedor Svechkov,2021-22,St. Petersburg SKA Jr.,Rus-MHL,4,0,8,8,0,8
Fedor Svechkov,2021-22,St. Petersburg SKA,KHL,4,0,0,0,0,2
Fedor Svechkov,2022-23,Moscow Spartak,KHL,27,2,2,4,15,-7
Fedor Svechkov,2022-23,Voskresensk Khimik,Rus-VHL,14,1,6,7,0,4
Fedor Svechkov,2022-23,Moscow Spartak Jr.,Rus-MHL,5,4,4,8,0,6
Fedor Svechkov,2023-24,Milwaukee Admirals,AHL,57,16,23,39,18,12
Fedor Svechkov,2024-25,Milwaukee Admirals*,AHL,13,5,7,12,10,3
Fedor Svechkov,2024-25,Nashville Predators,NHL,25,6,3,9,4,-5
Vasily Ponomarev,2018-19,Krylya Sovetov Jr.,Rus-MHL,37,9,20,29,12,4
Vasily Ponomarev,2019-20,Shawinigan Cataractes,QMJHL,57,18,31,49,15,-9
Vasily Ponomarev,2020-21,Shawinigan Cataractes,QMJHL,33,10,28,38,16,9
Vasily Ponomarev,2021-22,Voskresensk Khimik,Rus-VHL,21,7,6,13,8,2
Vasily Ponomarev,2021-22,Moscow Spartak Jr.,Rus-MHL,4,2,7,9,4,10
Vasily Ponomarev,2021-22,Moscow Spartak,KHL,14,1,1,2,0,2
Vasily Ponomarev,2021-22,Chicago Wolves üèÜ,AHL,11,3,7,10,4,5
Vasily Ponomarev,2022-23,Chicago Wolves,AHL,64,24,22,46,32,-11
Vasily Ponomarev,2023-24,Carolina Hurricanes,NHL,2,1,1,2,0,1
Vasily Ponomarev,2023-24,Tucson Roadrunners,AHL,2,0,0,0,0,-2
Vasily Ponomarev,2023-24,Chicago Wolves,AHL,39,8,21,29,14,-15
Vasily Ponomarev,2023-24,Wilkes-Barre/Scranton Penguins,AHL,4,1,0,1,2,-3
Vasily Ponomarev,2024-25,Pittsburgh Penguins*,NHL,4,0,0,0,2,-1
Vasily Ponomarev,2024-25,Wilkes-Barre/Scranton Penguins,AHL,35,11,19,30,38,6
K'Andre Miller,2016-17,U.S. National Under-17 Team,USHL,34,0,7,7,12,-29
K'Andre Miller,2017-18,U.S. National Under-18 Team,USHL,22,4,12,16,6,13
K'Andre Miller,2017-18,U.S. National Under-18 Team,Exhibition,36,5,8,13,20,10
K'Andre Miller,2018-19,U. of Wisconsin,Big-10,26,5,17,22,18,7
K'Andre Miller,2019-20,U. of Wisconsin,Big-10,36,7,11,18,24,-7
K'Andre Miller,2020-21,New York Rangers,NHL,53,5,7,12,20,9
K'Andre Miller,2021-22,New York Rangers,NHL,82,7,13,20,24,23
K'Andre Miller,2022-23,New York Rangers,NHL,79,9,34,43,47,12
K'Andre Miller,2023-24,New York Rangers,NHL,80,8,22,30,49,5
K'Andre Miller,2024-25,New York Rangers,NHL,49,4,9,13,10,-5
Donovan Sebrango,2017-18,Ottawa Jr. Senators,CCHL,4,0,0,0,0,
Donovan Sebrango,2018-19,Kitchener Rangers,OHL,62,7,19,26,54,-20
Donovan Sebrango,2019-20,Kitchener Rangers,OHL,56,6,24,30,33,0
Donovan Sebrango,2020-21,Grand Rapids Griffins,AHL,31,0,4,4,18,1
Donovan Sebrango,2021-22,Grand Rapids Griffins,AHL,65,1,6,7,23,-7
Donovan Sebrango,2022-23,Grand Rapids Griffins,AHL,39,4,3,7,19,-11
Donovan Sebrango,2022-23,Toledo Walleye,ECHL,23,1,11,12,6,11
Donovan Sebrango,2023-24,Belleville Senators,AHL,35,0,7,7,65,3
Donovan Sebrango,2023-24,Allen Americans,ECHL,4,1,1,2,0,-1
Donovan Sebrango,2024-25,Ottawa Senators*,NHL,2,0,0,0,0,-1
Donovan Sebrango,2024-25,Belleville Senators,AHL,38,6,10,16,64,2
Zach Hyman,2008-09,Hamilton Red Wings,OJHL,49,13,24,37,24,
Zach Hyman,2009-10,Hamilton Red Wings,OJHL,49,35,40,75,30,17
Zach Hyman,2010-11,Hamilton Red Wings,OJHL,43,42,60,102,24,
Zach Hyman,2011-12,U. of Michigan,CCHA,41,2,7,9,12,
Zach Hyman,2012-13,U. of Michigan,CCHA,38,4,5,9,8,
Zach Hyman,2013-14,U. of Michigan,Big-10,35,7,10,17,12,
Zach Hyman,2014-15,U. of Michigan,Big-10,37,22,32,54,10,24
Zach Hyman,2015-16,Toronto Marlies,AHL,59,15,22,37,24,31
Zach Hyman,2015-16,Toronto Maple Leafs,NHL,16,4,2,6,18,0
Zach Hyman,2016-17,Toronto Maple Leafs,NHL,82,10,18,28,30,2
Zach Hyman,2017-18,Toronto Maple Leafs,NHL,82,15,25,40,37,22
Zach Hyman,2018-19,Toronto Maple Leafs,NHL,71,21,20,41,65,16
Zach Hyman,2019-20,Toronto Maple Leafs,NHL,51,21,16,37,23,13
Zach Hyman,2020-21,Toronto Maple Leafs,NHL,43,15,18,33,28,19
Zach Hyman,2021-22,Edmonton Oilers,NHL,76,27,27,54,36,-9
Zach Hyman,2022-23,Edmonton Oilers,NHL,79,36,47,83,39,13
Zach Hyman,2023-24,Edmonton Oilers,NHL,80,54,23,77,48,36
Zach Hyman,2024-25,Edmonton Oilers,NHL,51,19,13,32,24,10
Peyton Krebs,2016-17,Kootenay Ice,WHL,6,1,5,6,0,-5
Peyton Krebs,2017-18,Kootenay Ice,WHL,67,17,37,54,40,-22
Peyton Krebs,2018-19,Kootenay Ice,WHL,64,19,49,68,63,-50
Peyton Krebs,2019-20,Winnipeg Ice,WHL,38,12,48,60,38,11
Peyton Krebs,2020-21,Vegas Golden Knights,NHL,4,0,1,1,0,1
Peyton Krebs,2020-21,Henderson Silver Knights,AHL,5,1,4,5,0,6
Peyton Krebs,2020-21,Winnipeg Ice,WHL,24,13,30,43,28,11
Peyton Krebs,2021-22,Vegas Golden Knights,NHL,9,0,0,0,2,-6
Peyton Krebs,2021-22,Henderson Silver Knights,AHL,2,0,5,5,4,1
Peyton Krebs,2021-22,Rochester Americans,AHL,18,4,11,15,12,-12
Peyton Krebs,2021-22,Buffalo Sabres,NHL,48,7,15,22,20,-20
Peyton Krebs,2022-23,Buffalo Sabres,NHL,74,9,17,26,50,-8
Peyton Krebs,2023-24,Buffalo Sabres,NHL,80,4,13,17,67,2
Peyton Krebs,2024-25,Buffalo Sabres,NHL,53,4,12,16,28,-5
Scott Perunovich,2016-17,Cedar Rapids RoughRiders,USHL,56,6,15,21,14,-37
Scott Perunovich,2017-18,U. of Minnesota-Duluth,NCHC,42,11,25,36,36,22
Scott Perunovich,2018-19,U. of Minnesota-Duluth,NCHC,39,3,26,29,32,9
Scott Perunovich,2019-20,U. of Minnesota-Duluth,NCHC,34,6,34,40,64,18
Scott Perunovich,2021-22,St. Louis Blues,NHL,19,0,6,6,8,2
Scott Perunovich,2021-22,Springfield Thunderbirds,AHL,17,3,19,22,8,-3
Scott Perunovich,2022-23,Springfield Thunderbirds,AHL,22,2,18,20,12,3
Scott Perunovich,2023-24,St. Louis Blues,NHL,54,0,17,17,12,1
Scott Perunovich,2024-25,St. Louis Blues*,NHL,24,2,4,6,6,1
Scott Perunovich,2024-25,New York Islanders,NHL,7,0,3,3,4,1
Adam Edstrom,2016-17,Mora IK Jr.,Swe-Jr,28,2,1,3,6,-6
Adam Edstrom,2017-18,Mora IK Jr.,Swe-Jr,21,6,2,8,10,-12
Adam Edstrom,2018-19,Mora IK,SweHL,15,0,1,1,0,-2
Adam Edstrom,2018-19,Mora IK Jr.,Swe-Jr,20,11,5,16,12,-2
Adam Edstrom,2019-20,Rogle BK Angelholm,SweHL,46,4,5,9,14,-7
Adam Edstrom,2019-20,Rogle BK Jr.,Swe-Jr,1,0,0,0,0,-1
Adam Edstrom,2020-21,Rogle BK Angelholm,SweHL,43,3,7,10,33,6
Adam Edstrom,2021-22,Rogle BK Angelholm,SweHL,43,7,2,9,6,2
Adam Edstrom,2022-23,Hartford Wolf Pack,AHL,3,1,0,1,0,1
Adam Edstrom,2022-23,Rogle BK Angelholm,SweHL,42,9,10,19,35,4
Adam Edstrom,2023-24,Hartford Wolf Pack,AHL,40,11,5,16,16,-4
Adam Edstrom,2023-24,New York Rangers,NHL,11,2,0,2,2,2
Adam Edstrom,2024-25,New York Rangers*,NHL,51,5,4,9,27,-5
Nicolas Deslauriers,2007-08,Rouyn-Noranda Huskies,QMJHL,42,2,7,9,38,-7
Nicolas Deslauriers,2008-09,Rouyn-Noranda Huskies,QMJHL,68,11,19,30,80,3
Nicolas Deslauriers,2009-10,Rouyn-Noranda Huskies,QMJHL,65,9,36,45,72,22
Nicolas Deslauriers,2010-11,Gatineau Olympiques,QMJHL,48,13,30,43,53,22
Nicolas Deslauriers,2011-12,Manchester Monarchs,AHL,65,1,13,14,67,-14
Nicolas Deslauriers,2012-13,Manchester Monarchs,AHL,63,4,19,23,80,-14
Nicolas Deslauriers,2013-14,Manchester Monarchs,AHL,60,18,21,39,76,3
Nicolas Deslauriers,2013-14,Rochester Americans,AHL,5,1,2,3,9,0
Nicolas Deslauriers,2013-14,Buffalo Sabres,NHL,17,1,0,1,18,-10
Nicolas Deslauriers,2014-15,Buffalo Sabres,NHL,82,5,10,15,71,-24
Nicolas Deslauriers,2015-16,Buffalo Sabres,NHL,70,6,6,12,59,-14
Nicolas Deslauriers,2016-17,Buffalo Sabres,NHL,42,0,2,2,38,-6
Nicolas Deslauriers,2017-18,Laval Rocket,AHL,14,3,2,5,16,6
Nicolas Deslauriers,2017-18,Montreal Canadiens,NHL,58,10,4,14,55,7
Nicolas Deslauriers,2018-19,Montreal Canadiens,NHL,48,2,3,5,22,-12
Nicolas Deslauriers,2019-20,Anaheim Ducks,NHL,59,7,6,13,92,-1
Nicolas Deslauriers,2020-21,Anaheim Ducks,NHL,49,5,5,10,53,-7
Nicolas Deslauriers,2021-22,Anaheim Ducks,NHL,61,5,5,10,90,-9
Nicolas Deslauriers,2021-22,Minnesota Wild,NHL,20,3,0,3,23,-2
Nicolas Deslauriers,2022-23,Philadelphia Flyers,NHL,80,6,6,12,136,-11
Nicolas Deslauriers,2023-24,Philadelphia Flyers,NHL,60,1,3,4,89,-7
Nicolas Deslauriers,2024-25,Philadelphia Flyers,NHL,10,0,1,1,10,1
Kevin Fiala,2012-13,Malmo Jr.,Swe-Jr,33,9,19,28,28,-6
Kevin Fiala,2013-14,HV71 Jr.,Swe-Jr,27,10,15,25,40,10
Kevin Fiala,2013-14,HV71 Jonkoping,SweHL,17,3,8,11,10,-2
Kevin Fiala,2014-15,HV71 Jonkoping,SweHL,20,5,9,14,14,-3
Kevin Fiala,2014-15,Milwaukee Admirals,AHL,33,11,9,20,18,-5
Kevin Fiala,2014-15,Nashville Predators,NHL,1,0,0,0,0,-1
Kevin Fiala,2015-16,Milwaukee Admirals,AHL,66,18,32,50,78,-19
Kevin Fiala,2015-16,Nashville Predators,NHL,5,1,0,1,0,0
Kevin Fiala,2016-17,Nashville Predators,NHL,54,11,5,16,18,1
Kevin Fiala,2016-17,Milwaukee Admirals,AHL,22,7,12,19,45,8
Kevin Fiala,2017-18,Nashville Predators,NHL,80,23,25,48,26,20
Kevin Fiala,2018-19,Nashville Predators,NHL,64,10,22,32,26,-11
Kevin Fiala,2018-19,Minnesota Wild,NHL,19,3,4,7,10,-12
Kevin Fiala,2019-20,Minnesota Wild,NHL,64,23,31,54,42,-1
Kevin Fiala,2020-21,Minnesota Wild,NHL,50,20,20,40,43,-2
Kevin Fiala,2021-22,Minnesota Wild,NHL,82,33,52,85,52,23
Kevin Fiala,2022-23,Los Angeles Kings,NHL,69,23,49,72,52,2
Kevin Fiala,2023-24,Los Angeles Kings,NHL,82,29,44,73,62,1
Kevin Fiala,2024-25,Los Angeles Kings,NHL,52,21,14,35,32,-8
Corey Perry,2000-01,Peterborough Bees,OPJHL,2,1,0,1,0,
Corey Perry,2001-02,London Knights,OHL,60,28,31,59,56,10
Corey Perry,2002-03,London Knights,OHL,67,25,53,78,145,6
Corey Perry,2003-04,London Knights,OHL,66,40,73,113,98,38
Corey Perry,2003-04,Cincinnati Mighty Ducks,AHL,--,--,--,--,--,--
Corey Perry,2004-05,London Knights üèÜ,OHL,60,47,83,130,117,66
Corey Perry,2005-06,Anaheim Mighty Ducks,NHL,56,13,12,25,50,1
Corey Perry,2005-06,Portland Pirates,AHL,19,16,18,34,32,7
Corey Perry,2006-07,Anaheim Ducks üèÜ,NHL,82,17,27,44,55,12
Corey Perry,2007-08,Anaheim Ducks,NHL,70,29,25,54,108,12
Corey Perry,2008-09,Anaheim Ducks,NHL,78,32,40,72,109,10
Corey Perry,2009-10,Anaheim Ducks,NHL,82,27,49,76,111,0
Corey Perry,2010-11,Anaheim Ducks,NHL,82,50,48,98,104,9
Corey Perry,2011-12,Anaheim Ducks,NHL,80,37,23,60,127,-7
Corey Perry,2012-13,Anaheim Ducks,NHL,44,15,21,36,72,10
Corey Perry,2013-14,Anaheim Ducks,NHL,81,43,39,82,65,32
Corey Perry,2014-15,Anaheim Ducks,NHL,67,33,22,55,67,13
Corey Perry,2015-16,Anaheim Ducks,NHL,82,34,28,62,68,2
Corey Perry,2016-17,Anaheim Ducks,NHL,82,19,34,53,76,2
Corey Perry,2017-18,Anaheim Ducks,NHL,71,17,32,49,71,-4
Corey Perry,2018-19,Anaheim Ducks,NHL,31,6,4,10,27,-16
Corey Perry,2019-20,Dallas Stars,NHL,57,5,16,21,70,-2
Corey Perry,2020-21,Montreal Canadiens,NHL,49,9,12,21,39,-4
Corey Perry,2021-22,Tampa Bay Lightning,NHL,82,19,21,40,66,9
Corey Perry,2022-23,Tampa Bay Lightning,NHL,81,12,13,25,95,-28
Corey Perry,2023-24,Chicago Blackhawks,NHL,16,4,5,9,12,-5
Corey Perry,2023-24,Edmonton Oilers,NHL,38,8,5,13,34,-1
Corey Perry,2024-25,Edmonton Oilers,NHL,55,12,8,20,27,10
Noah Juulsen,2012-13,Everett Silvertips,WHL,1,0,0,0,0,-1
Noah Juulsen,2013-14,Everett Silvertips,WHL,59,2,8,10,32,12
Noah Juulsen,2014-15,Everett Silvertips,WHL,68,9,43,52,42,22
Noah Juulsen,2015-16,Everett Silvertips,WHL,63,7,21,28,37,0
Noah Juulsen,2016-17,Everett Silvertips,WHL,49,12,22,34,38,15
Noah Juulsen,2016-17,St. John's IceCaps,AHL,--,--,--,--,--,--
Noah Juulsen,2017-18,Montreal Canadiens,NHL,23,1,2,3,4,1
Noah Juulsen,2017-18,Laval Rocket,AHL,31,1,5,6,8,-9
Noah Juulsen,2018-19,Montreal Canadiens,NHL,21,1,4,5,6,5
Noah Juulsen,2018-19,Laval Rocket,AHL,3,0,0,0,0,-1
Noah Juulsen,2019-20,Laval Rocket,AHL,13,0,3,3,4,6
Noah Juulsen,2020-21,Florida Panthers,NHL,4,0,0,0,0,-3
Noah Juulsen,2020-21,Syracuse Crunch,AHL,5,0,1,1,2,-1
Noah Juulsen,2021-22,Abbotsford Canucks,AHL,50,3,13,16,63,-9
Noah Juulsen,2021-22,Vancouver Canucks,NHL,8,0,2,2,0,-4
Noah Juulsen,2022-23,Vancouver Canucks,NHL,12,0,0,0,6,1
Noah Juulsen,2022-23,Abbotsford Canucks,AHL,49,3,17,20,34,9
Noah Juulsen,2023-24,Vancouver Canucks,NHL,54,1,6,7,22,-1
Noah Juulsen,2024-25,Vancouver Canucks*,NHL,35,0,0,0,21,-12
Jan Jenik,2017-18,Liberec Bili Tygri HC,Czech,6,0,0,0,4,1
Jan Jenik,2018-19,Liberec Bili Tygri HC,Czech,10,0,2,2,16,-1
Jan Jenik,2018-19,Hamilton Bulldogs,OHL,27,13,17,30,49,-8
Jan Jenik,2019-20,Hamilton Bulldogs,OHL,27,22,34,56,30,12
Jan Jenik,2020-21,Arizona Coyotes,NHL,2,2,0,2,0,3
Jan Jenik,2020-21,Kettera Imatra,Mestis,7,5,3,8,6,0
Jan Jenik,2020-21,Tucson Roadrunners,AHL,29,6,8,14,50,-11
Jan Jenik,2021-22,Tucson Roadrunners,AHL,51,17,30,47,67,-27
Jan Jenik,2021-22,Arizona Coyotes,NHL,13,2,1,3,11,-6
Jan Jenik,2022-23,Arizona Coyotes,NHL,2,0,0,0,4,0
Jan Jenik,2022-23,Tucson Roadrunners,AHL,30,7,16,23,50,3
Jan Jenik,2023-24,Arizona Coyotes,NHL,5,0,1,1,5,-1
Jan Jenik,2023-24,Tucson Roadrunners,AHL,55,16,20,36,48,4
Jan Jenik,2024-25,Ottawa Senators*,NHL,1,0,0,0,0,-1
Jan Jenik,2024-25,Belleville Senators,AHL,28,6,5,11,54,-2
Joel Hanley,2007-08,Newmarket Hurricanes,OPJHL,2,0,0,0,0,
Joel Hanley,2008-09,Newmarket Hurricanes,OJHL,50,14,24,38,61,
Joel Hanley,2009-10,Newmarket Hurricanes,OJHL,23,5,15,20,11,2
Joel Hanley,2010-11,UMass-Amherst,H-East,28,3,15,18,24,
Joel Hanley,2011-12,UMass-Amherst,H-East,36,7,18,25,18,
Joel Hanley,2012-13,UMass-Amherst,H-East,33,5,11,16,46,
Joel Hanley,2013-14,UMass-Amherst,H-East,34,2,14,16,39,
Joel Hanley,2013-14,Portland Pirates,AHL,15,0,5,5,6,-4
Joel Hanley,2014-15,Gwinnett Gladiators,ECHL,3,1,0,1,0,2
Joel Hanley,2014-15,Portland Pirates,AHL,63,2,15,17,34,7
Joel Hanley,2015-16,St. John's IceCaps,AHL,64,5,8,13,25,-11
Joel Hanley,2015-16,Montreal Canadiens,NHL,10,0,6,6,0,0
Joel Hanley,2016-17,St. John's IceCaps,AHL,65,2,20,22,34,11
Joel Hanley,2016-17,Montreal Canadiens,NHL,7,0,0,0,4,-3
Joel Hanley,2017-18,Tucson Roadrunners,AHL,52,2,18,20,31,30
Joel Hanley,2017-18,Arizona Coyotes,NHL,5,0,0,0,0,0
Joel Hanley,2018-19,Texas Stars,AHL,60,8,20,28,32,10
Joel Hanley,2018-19,Dallas Stars,NHL,16,0,0,0,2,0
Joel Hanley,2019-20,Texas Stars,AHL,40,0,10,10,8,10
Joel Hanley,2019-20,Dallas Stars,NHL,8,0,2,2,6,0
Joel Hanley,2020-21,Dallas Stars,NHL,35,0,8,8,2,6
Joel Hanley,2021-22,Dallas Stars,NHL,44,2,4,6,4,-13
Joel Hanley,2022-23,Dallas Stars,NHL,26,0,2,2,15,5
Joel Hanley,2023-24,Dallas Stars,NHL,32,0,3,3,23,3
Joel Hanley,2023-24,Calgary Flames,NHL,10,1,1,2,7,
Joel Hanley,2024-25,Calgary Flames,NHL,27,0,3,3,6,3
Max Domi,2010-11,St. Michael's Buzzers,OJHL,2,1,1,2,0,
Max Domi,2011-12,London Knights üèÜ,OHL,62,21,28,49,48,13
Max Domi,2012-13,London Knights üèÜ,OHL,64,39,48,87,71,33
Max Domi,2013-14,London Knights,OHL,61,34,59,93,90,24
Max Domi,2014-15,London Knights,OHL,57,32,70,102,66,24
Max Domi,2015-16,Arizona Coyotes,NHL,81,18,34,52,72,3
Max Domi,2016-17,Arizona Coyotes,NHL,59,9,29,38,40,-9
Max Domi,2017-18,Arizona Coyotes,NHL,82,9,36,45,73,-7
Max Domi,2018-19,Montreal Canadiens,NHL,82,28,44,72,80,20
Max Domi,2019-20,Montreal Canadiens,NHL,71,17,27,44,35,-3
Max Domi,2020-21,Columbus Blue Jackets,NHL,54,9,15,24,75,-18
Max Domi,2021-22,Columbus Blue Jackets,NHL,53,9,23,32,37,2
Max Domi,2021-22,Carolina Hurricanes,NHL,19,2,5,7,18,8
Max Domi,2022-23,Chicago Blackhawks,NHL,60,18,31,49,76,-9
Max Domi,2022-23,Dallas Stars,NHL,20,2,5,7,6,-6
Max Domi,2023-24,Toronto Maple Leafs,NHL,80,9,38,47,118,10
Max Domi,2024-25,Toronto Maple Leafs,NHL,47,3,17,20,34,1
Emil Andrae,2017-18,Oskarshamn IK,Swe-1,4,0,0,0,2,0
Emil Andrae,2018-19,HV71 Jr.,Swe-Jr,23,2,5,7,22,4
Emil Andrae,2019-20,HV71 Jr.,Swe-Jr,40,11,27,38,82,12
Emil Andrae,2019-20,HV71 Jonkoping,SweHL,10,0,0,0,4,-1
Emil Andrae,2020-21,HV71 Jr.,Swe-Jr,1,0,1,1,0,0
Emil Andrae,2020-21,HV71 Jonkoping,SweHL,31,0,7,7,6,-7
Emil Andrae,2020-21,Vasterviks IK,Swe-1,15,3,3,6,4,-5
Emil Andrae,2021-22,HV71 Jonkoping üèÜ,Swe-1,41,9,24,33,18,19
Emil Andrae,2022-23,HV71 Jonkoping,SweHL,51,6,20,26,67,-3
Emil Andrae,2022-23,Lehigh Valley Phantoms,AHL,10,2,4,6,6,-4
Emil Andrae,2023-24,Philadelphia Flyers,NHL,4,0,0,0,0,-1
Emil Andrae,2023-24,Lehigh Valley Phantoms,AHL,61,5,27,32,66,-10
Emil Andrae,2024-25,Philadelphia Flyers*,NHL,24,1,5,6,14,2
Emil Andrae,2024-25,Lehigh Valley Phantoms,AHL,20,3,9,12,12,10
Will Cuylle,2018-19,Windsor Spitfires,OHL,63,26,15,41,50,3
Will Cuylle,2019-20,Windsor Spitfires,OHL,62,22,20,42,37,-2
Will Cuylle,2020-21,Hartford Wolf Pack,AHL,18,2,3,5,35,-4
Will Cuylle,2021-22,Windsor Spitfires,OHL,59,43,37,80,48,22
Will Cuylle,2022-23,New York Rangers,NHL,4,0,0,0,10,-2
Will Cuylle,2022-23,Hartford Wolf Pack,AHL,69,25,20,45,59,10
Will Cuylle,2023-24,New York Rangers,NHL,81,13,8,21,56,-3
Will Cuylle,2024-25,New York Rangers,NHL,55,14,15,29,28,6
Erik Haula,2009-10,Omaha Lancers,USHL,56,28,44,72,59,36
Erik Haula,2010-11,U. of Minnesota,WCHA,34,6,18,24,22,
Erik Haula,2011-12,U. of Minnesota,WCHA,43,20,29,49,30,
Erik Haula,2012-13,U. of Minnesota,WCHA,37,16,35,51,14,
Erik Haula,2012-13,Houston Aeros,AHL,6,0,2,2,2,1
Erik Haula,2013-14,Iowa Wild,AHL,31,14,13,27,14,2
Erik Haula,2013-14,Minnesota Wild,NHL,46,6,9,15,29,14
Erik Haula,2014-15,Minnesota Wild,NHL,72,7,7,14,32,-7
Erik Haula,2015-16,Minnesota Wild,NHL,76,14,20,34,24,21
Erik Haula,2016-17,Minnesota Wild,NHL,72,15,11,26,28,5
Erik Haula,2017-18,Vegas Golden Knights,NHL,76,29,26,55,37,-16
Erik Haula,2018-19,Vegas Golden Knights,NHL,15,2,5,7,10,1
Erik Haula,2019-20,Carolina Hurricanes,NHL,41,12,10,22,20,1
Erik Haula,2019-20,Florida Panthers,NHL,7,0,2,2,2,0
Erik Haula,2020-21,Nashville Predators,NHL,51,9,12,21,14,4
Erik Haula,2021-22,Boston Bruins,NHL,78,18,26,44,47,19
Erik Haula,2022-23,New Jersey Devils,NHL,80,14,27,41,47,13
Erik Haula,2023-24,New Jersey Devils,NHL,76,16,19,35,54,-1
Erik Haula,2024-25,New Jersey Devils,NHL,45,5,6,11,31,-8
Dakota Mermis,2009-10,Lincoln Stars,USHL,2,0,1,1,0,1
Dakota Mermis,2010-11,U.S. National Development Team,USHL,36,4,4,8,53,-2
Dakota Mermis,2011-12,Green Bay Gamblers üèÜ,USHL,60,5,22,27,98,22
Dakota Mermis,2012-13,U. of Denver,WCHA,19,1,3,4,14,
Dakota Mermis,2012-13,London Knights üèÜ,OHL,27,2,9,11,34,15
Dakota Mermis,2013-14,London Knights,OHL,66,5,20,25,76,40
Dakota Mermis,2014-15,London Knights,OHL,36,1,10,11,36,22
Dakota Mermis,2014-15,Oshawa Generals üèÜ,OHL,30,5,14,19,50,26
Dakota Mermis,2015-16,Springfield Falcons,AHL,63,3,10,13,58,-12
Dakota Mermis,2015-16,Rapid City Rush,ECHL,5,1,2,3,6,1
Dakota Mermis,2016-17,Tucson Roadrunners,AHL,67,2,10,12,75,-17
Dakota Mermis,2017-18,Tucson Roadrunners,AHL,59,2,17,19,45,5
Dakota Mermis,2017-18,Arizona Coyotes,NHL,9,0,0,0,0,-2
Dakota Mermis,2018-19,Tucson Roadrunners,AHL,62,3,21,24,49,-2
Dakota Mermis,2018-19,Arizona Coyotes,NHL,1,0,0,0,0,1
Dakota Mermis,2019-20,Binghamton Devils,AHL,53,3,16,19,23,6
Dakota Mermis,2019-20,New Jersey Devils,NHL,10,1,3,4,4,7
Dakota Mermis,2020-21,Minnesota Wild,NHL,3,0,0,0,0,0
Dakota Mermis,2021-22,Iowa Wild,AHL,59,3,21,24,86,-9
Dakota Mermis,2021-22,Minnesota Wild,NHL,2,0,0,0,0,2
Dakota Mermis,2022-23,Minnesota Wild,NHL,2,0,0,0,0,-1
Dakota Mermis,2022-23,Iowa Wild,AHL,63,5,21,26,73,9
Dakota Mermis,2023-24,Minnesota Wild,NHL,47,3,5,8,33,-2
Dakota Mermis,2023-24,Iowa Wild,AHL,5,0,2,2,12,
Dakota Mermis,2024-25,Utah Hockey Club*,NHL,1,0,0,0,2,-2
Dakota Mermis,2024-25,Toronto Maple Leafs*,NHL,--,Statistics Unavailable,,,,
Dakota Mermis,2024-25,Toronto Marlies,AHL,17,0,6,6,8,5
Adam Fox,2014-15,U.S. National Under-18 Team,USHL,1,0,0,0,0,1
Adam Fox,2014-15,U.S. National Under-17 Team,USHL,33,3,14,17,26,-13
Adam Fox,2015-16,U.S. National Under-18 Team,USHL,25,5,17,22,2,12
Adam Fox,2016-17,Harvard University,ECAC,35,6,34,40,6,19
Adam Fox,2017-18,Harvard University,ECAC,29,6,22,28,12,3
Adam Fox,2018-19,Harvard University,ECAC,33,9,39,48,14,23
Adam Fox,2019-20,New York Rangers,NHL,70,8,34,42,32,22
Adam Fox,2020-21,New York Rangers,NHL,55,5,42,47,14,19
Adam Fox,2021-22,New York Rangers,NHL,78,11,63,74,26,18
Adam Fox,2022-23,New York Rangers,NHL,82,12,60,72,34,28
Adam Fox,2023-24,New York Rangers,NHL,72,17,56,73,36,21
Adam Fox,2024-25,New York Rangers,NHL,55,4,40,44,26,6
Henry Thrun,2017-18,U.S. National Under-17 Team,Exhibition,26,4,15,19,4,9
Henry Thrun,2017-18,U.S. National Under-17 Team,USHL,32,3,17,20,8,13
Henry Thrun,2017-18,U.S. National Under-18 Team,USHL,2,0,0,0,0,2
Henry Thrun,2018-19,U.S. National Under-18 Team,Exhibition,36,4,10,14,6,16
Henry Thrun,2018-19,U.S. National Under-18 Team,USHL,28,4,19,23,16,28
Henry Thrun,2019-20,Harvard University,ECAC,31,3,18,21,12,17
Henry Thrun,2020-21,Dubuque Fighting Saints,USHL,24,8,14,22,4,4
Henry Thrun,2021-22,Harvard University,ECAC,35,7,25,32,10,9
Henry Thrun,2022-23,Harvard University,ECAC,33,7,24,31,14,20
Henry Thrun,2022-23,San Jose Sharks,NHL,8,0,2,2,0,-3
Henry Thrun,2023-24,San Jose Sharks,NHL,51,3,8,11,16,-22
Henry Thrun,2023-24,San Jose Barracuda,AHL,18,1,5,6,10,-9
Henry Thrun,2024-25,San Jose Sharks,NHL,48,1,9,10,24,-15
Aatu Raty,2019-20,Karpat,SM-liiga,12,2,2,4,2,0
Aatu Raty,2020-21,Karpat,SM-liiga,35,3,3,6,18,0
Aatu Raty,2021-22,Karpat,SM-liiga,6,0,1,1,2,-1
Aatu Raty,2021-22,Jukurit Mikkeli,SM-liiga,41,13,27,40,32,26
Aatu Raty,2021-22,Bridgeport Islanders,AHL,2,0,0,0,0,-2
Aatu Raty,2022-23,New York Islanders,NHL,12,2,0,2,4,1
Aatu Raty,2022-23,Bridgeport Islanders,AHL,27,7,8,15,12,3
Aatu Raty,2022-23,Abbotsford Canucks,AHL,25,2,10,12,6,2
Aatu Raty,2022-23,Vancouver Canucks,NHL,3,0,1,1,0,-1
Aatu Raty,2023-24,Abbotsford Canucks,AHL,72,18,34,52,18,2
Aatu Raty,2024-25,Vancouver Canucks*,NHL,21,2,2,4,8,-2
Aatu Raty,2024-25,Abbotsford Canucks,AHL,29,12,17,29,24,6
Jake Sanderson,2018-19,U.S. National Under-17 Team,Exhibition,22,2,15,17,18,2
Jake Sanderson,2018-19,U.S. National Under-17 Team,USHL,22,2,5,7,0,-22
Jake Sanderson,2019-20,U.S. National Under-18 Team,USHL,19,2,12,14,8,6
Jake Sanderson,2020-21,U. of North Dakota,NCHC,22,2,13,15,4,20
Jake Sanderson,2021-22,U. of North Dakota,NCHC,23,8,18,26,6,5
Jake Sanderson,2022-23,Ottawa Senators,NHL,77,4,28,32,12,-6
Jake Sanderson,2023-24,Ottawa Senators,NHL,79,10,28,38,23,8
Jake Sanderson,2024-25,Ottawa Senators,NHL,55,5,30,35,8,-15
Logan Stanley,2014-15,Windsor Spitfires,OHL,59,0,4,4,60,-25
Logan Stanley,2015-16,Windsor Spitfires,OHL,64,5,12,17,103,7
Logan Stanley,2016-17,Windsor Spitfires,OHL,35,4,13,17,62,2
Logan Stanley,2017-18,Kitchener Rangers,OHL,61,15,27,42,111,6
Logan Stanley,2018-19,Manitoba Moose,AHL,73,6,16,22,70,-9
Logan Stanley,2019-20,Manitoba Moose,AHL,44,3,7,10,73,-17
Logan Stanley,2020-21,Winnipeg Jets,NHL,37,1,3,4,26,13
Logan Stanley,2021-22,Winnipeg Jets,NHL,58,1,12,13,44,1
Logan Stanley,2022-23,Winnipeg Jets,NHL,19,1,2,3,21,-1
Logan Stanley,2023-24,Winnipeg Jets,NHL,25,1,1,2,36,4
Logan Stanley,2024-25,Winnipeg Jets,NHL,42,1,8,9,61,10
Justin Dowling,2006-07,Swift Current Broncos,WHL,3,0,3,3,0,3
Justin Dowling,2007-08,Swift Current Broncos,WHL,71,7,21,28,4,2
Justin Dowling,2008-09,Swift Current Broncos,WHL,71,22,44,66,16,27
Justin Dowling,2009-10,Swift Current Broncos,WHL,72,32,46,78,19,1
Justin Dowling,2010-11,Swift Current Broncos,WHL,63,20,47,67,18,-11
Justin Dowling,2010-11,Abbotsford Heat,AHL,8,1,3,4,2,0
Justin Dowling,2011-12,Utah Grizzlies,ECHL,26,6,18,24,6,-2
Justin Dowling,2011-12,Abbotsford Heat,AHL,22,1,1,2,6,-7
Justin Dowling,2012-13,Idaho Steelheads,ECHL,34,13,33,46,16,7
Justin Dowling,2012-13,Texas Stars,AHL,38,16,14,30,4,16
Justin Dowling,2013-14,Texas Stars üèÜ,AHL,74,12,35,47,8,21
Justin Dowling,2014-15,Texas Stars,AHL,65,24,26,50,22,0
Justin Dowling,2015-16,Texas Stars,AHL,52,11,35,46,10,3
Justin Dowling,2016-17,Texas Stars,AHL,49,8,20,28,8,2
Justin Dowling,2016-17,Dallas Stars,NHL,9,0,2,2,2,0
Justin Dowling,2017-18,Texas Stars,AHL,65,13,28,41,18,-6
Justin Dowling,2018-19,Texas Stars,AHL,62,13,40,53,12,-6
Justin Dowling,2018-19,Dallas Stars,NHL,11,0,1,1,0,-4
Justin Dowling,2019-20,Dallas Stars,NHL,29,3,3,6,8,-3
Justin Dowling,2019-20,Texas Stars,AHL,3,0,3,3,2,0
Justin Dowling,2020-21,Dallas Stars,NHL,27,1,4,5,6,-4
Justin Dowling,2021-22,Vancouver Canucks,NHL,22,2,2,4,2,-3
Justin Dowling,2021-22,Abbotsford Canucks,AHL,15,5,9,14,0,1
Justin Dowling,2022-23,Abbotsford Canucks,AHL,56,11,35,46,18,3
Justin Dowling,2023-24,New Jersey Devils,NHL,2,1,0,1,0,-2
Justin Dowling,2023-24,Utica Comets,AHL,57,14,26,40,20,-6
Justin Dowling,2024-25,Utica Comets*,AHL,7,2,2,4,0,-7
Justin Dowling,2024-25,New Jersey Devils,NHL,39,2,3,5,2,-1
Trent Frederic,2014-15,U.S. National Under-17 Team,USHL,34,3,1,4,30,-20
Trent Frederic,2014-15,U.S. National Under-18 Team,USHL,1,0,1,1,0,0
Trent Frederic,2015-16,U.S. National Under-18 Team,USHL,23,4,10,14,23,5
Trent Frederic,2016-17,U. of Wisconsin,Big-10,30,15,18,33,32,2
Trent Frederic,2017-18,U. of Wisconsin,Big-10,36,17,15,32,26,-9
Trent Frederic,2017-18,Providence Bruins,AHL,13,5,3,8,11,3
Trent Frederic,2018-19,Providence Bruins,AHL,55,14,11,25,67,2
Trent Frederic,2018-19,Boston Bruins,NHL,15,0,0,0,15,-4
Trent Frederic,2019-20,Providence Bruins,AHL,59,8,24,32,148,10
Trent Frederic,2019-20,Boston Bruins,NHL,2,0,0,0,0,-1
Trent Frederic,2020-21,Boston Bruins,NHL,42,4,1,5,65,-8
Trent Frederic,2021-22,Boston Bruins,NHL,60,8,10,18,57,10
Trent Frederic,2022-23,Boston Bruins,NHL,79,17,14,31,57,28
Trent Frederic,2023-24,Boston Bruins,NHL,82,18,22,40,69,9
Trent Frederic,2024-25,Boston Bruins,NHL,55,8,7,15,44,-13
Phillip Danault,2009-10,Victoriaville Tigres,QMJHL,61,10,18,28,54,19
Phillip Danault,2010-11,Victoriaville Tigres,QMJHL,64,23,44,67,59,17
Phillip Danault,2011-12,Victoriaville Tigres,QMJHL,62,18,53,71,61,11
Phillip Danault,2011-12,Rockford IceHogs,AHL,7,0,2,2,10,-5
Phillip Danault,2012-13,Victoriaville Tigres,QMJHL,29,14,30,44,28,-1
Phillip Danault,2012-13,Moncton Wildcats,QMJHL,27,9,32,41,22,17
Phillip Danault,2012-13,Rockford IceHogs,AHL,5,0,0,0,2,-1
Phillip Danault,2013-14,Rockford IceHogs,AHL,72,6,20,26,40,11
Phillip Danault,2014-15,Rockford IceHogs,AHL,70,13,25,38,38,20
Phillip Danault,2014-15,Chicago Blackhawks,NHL,2,0,0,0,0,0
Phillip Danault,2015-16,Rockford IceHogs,AHL,6,1,1,2,4,-2
Phillip Danault,2015-16,Chicago Blackhawks,NHL,30,1,4,5,6,-3
Phillip Danault,2015-16,Montreal Canadiens,NHL,21,3,2,5,8,-2
Phillip Danault,2016-17,Montreal Canadiens,NHL,82,13,27,40,35,5
Phillip Danault,2017-18,Montreal Canadiens,NHL,52,8,17,25,34,0
Phillip Danault,2018-19,Montreal Canadiens,NHL,81,12,41,53,39,17
Phillip Danault,2019-20,Montreal Canadiens,NHL,71,13,34,47,32,18
Phillip Danault,2020-21,Montreal Canadiens,NHL,53,5,19,24,24,9
Phillip Danault,2021-22,Los Angeles Kings,NHL,79,27,24,51,38,14
Phillip Danault,2022-23,Los Angeles Kings,NHL,82,18,36,54,63,-8
Phillip Danault,2023-24,Los Angeles Kings,NHL,78,17,30,47,18,12
Phillip Danault,2024-25,Los Angeles Kings,NHL,52,5,23,28,12,7
Luca Del Bel Belluz,2019-20,Mississauga Steelheads,OHL,58,1,5,6,8,-13
Luca Del Bel Belluz,2021-22,Mississauga Steelheads,OHL,68,30,46,76,28,23
Luca Del Bel Belluz,2022-23,Mississauga Steelheads,OHL,34,20,21,41,10,-5
Luca Del Bel Belluz,2022-23,Sarnia Sting,OHL,32,20,26,46,4,15
Luca Del Bel Belluz,2023-24,Cleveland Monsters,AHL,58,9,22,31,12,-2
Luca Del Bel Belluz,2023-24,Columbus Blue Jackets,NHL,1,1,0,1,0,1
Luca Del Bel Belluz,2024-25,Columbus Blue Jackets*,NHL,15,2,6,8,0,2
Luca Del Bel Belluz,2024-25,Cleveland Monsters,AHL,38,18,21,39,8,7
Artemi Panarin,2008-09,Chekhov Vityaz,KHL,5,0,1,1,2,-3
Artemi Panarin,2009-10,Chekhov Vityaz,KHL,20,1,7,8,16,1
Artemi Panarin,2009-10,Chekhov Russkie Vityaz,Rus-MHL,38,20,24,44,55,19
Artemi Panarin,2010-11,Chekhov Russkie Vityaz,Rus-MHL,13,5,12,17,22,14
Artemi Panarin,2010-11,Chekhov Vityaz,KHL,40,5,16,21,8,-6
Artemi Panarin,2011-12,Chekhov Vityaz,KHL,38,12,14,26,49,1
Artemi Panarin,2011-12,Kazan Ak-Bars,KHL,12,1,4,5,4,5
Artemi Panarin,2012-13,Chekhov Vityaz,KHL,40,11,7,18,22,-9
Artemi Panarin,2012-13,St. Petersburg SKA,KHL,3,0,0,0,2,1
Artemi Panarin,2013-14,St. Petersburg SKA,KHL,51,20,20,40,30,21
Artemi Panarin,2014-15,St. Petersburg SKA üèÜ,KHL,54,26,36,62,37,18
Artemi Panarin,2015-16,Chicago Blackhawks,NHL,80,30,47,77,32,8
Artemi Panarin,2016-17,Chicago Blackhawks,NHL,82,31,43,74,21,18
Artemi Panarin,2017-18,Columbus Blue Jackets,NHL,81,27,55,82,26,23
Artemi Panarin,2018-19,Columbus Blue Jackets,NHL,79,28,59,87,23,14
Artemi Panarin,2019-20,New York Rangers,NHL,69,32,63,95,20,36
Artemi Panarin,2020-21,New York Rangers,NHL,42,17,41,58,6,14
Artemi Panarin,2021-22,New York Rangers,NHL,75,22,74,96,18,21
Artemi Panarin,2022-23,New York Rangers,NHL,82,29,63,92,36,4
Artemi Panarin,2023-24,New York Rangers,NHL,82,49,71,120,24,18
Artemi Panarin,2024-25,New York Rangers,NHL,53,23,34,57,16,-7
Hendrix Lapierre,2018-19,Chicoutimi Sagueneens,QMJHL,48,13,32,45,18,5
Hendrix Lapierre,2019-20,Chicoutimi Sagueneens,QMJHL,19,2,15,17,10,4
Hendrix Lapierre,2020-21,Chicoutimi Sagueneens,QMJHL,21,8,23,31,12,8
Hendrix Lapierre,2021-22,Washington Capitals,NHL,6,1,0,1,2,2
Hendrix Lapierre,2021-22,Acadie-Bathurst Titan,QMJHL,40,21,30,51,22,15
Hendrix Lapierre,2022-23,Hershey Bears üèÜ,AHL,60,15,15,30,43,7
Hendrix Lapierre,2023-24,Washington Capitals,NHL,51,8,14,22,4,-1
Hendrix Lapierre,2023-24,Hershey Bears üèÜ,AHL,21,5,12,17,6,1
Hendrix Lapierre,2024-25,Washington Capitals*,NHL,27,0,8,8,4,-3
Hendrix Lapierre,2024-25,Hershey Bears,AHL,13,2,9,11,6,4
Dylan Coghlan,2013-14,Nanaimo Clippers,BCHL,2,0,0,0,0,
Dylan Coghlan,2014-15,Tri-City Americans,WHL,55,2,3,5,16,-9
Dylan Coghlan,2015-16,Tri-City Americans,WHL,70,4,20,24,39,5
Dylan Coghlan,2016-17,Tri-City Americans,WHL,71,15,38,53,26,17
Dylan Coghlan,2017-18,Tri-City Americans,WHL,69,17,46,63,65,-5
Dylan Coghlan,2018-19,Chicago Wolves,AHL,66,15,25,40,22,4
Dylan Coghlan,2019-20,Chicago Wolves,AHL,60,11,13,24,14,-9
Dylan Coghlan,2020-21,Vegas Golden Knights,NHL,29,3,3,6,2,-3
Dylan Coghlan,2021-22,Vegas Golden Knights,NHL,59,3,10,13,18,-5
Dylan Coghlan,2022-23,Carolina Hurricanes,NHL,17,0,3,3,2,-1
Dylan Coghlan,2022-23,Chicago Wolves,AHL,5,2,1,3,4,-2
Dylan Coghlan,2023-24,Carolina Hurricanes,NHL,1,0,0,0,0,-2
Dylan Coghlan,2023-24,Springfield Thunderbirds,AHL,61,16,25,41,40,-13
Dylan Coghlan,2024-25,Winnipeg Jets*,NHL,6,0,0,0,4,1
Dylan Coghlan,2024-25,Manitoba Moose,AHL,17,7,6,13,2,-11
Rasmus Kupari,2017-18,Karpat üèÜ,SM-liiga,39,6,8,14,12,4
Rasmus Kupari,2017-18,Hermes Kokkola,Mestis,5,1,3,4,4,-2
Rasmus Kupari,2018-19,Karpat,SM-liiga,43,12,21,33,65,13
Rasmus Kupari,2019-20,Ontario Reign,AHL,27,6,2,8,9,-8
Rasmus Kupari,2020-21,Los Angeles Kings,NHL,7,1,0,1,2,-5
Rasmus Kupari,2020-21,Ontario Reign,AHL,32,8,15,23,18,4
Rasmus Kupari,2021-22,Los Angeles Kings,NHL,57,5,8,13,18,-5
Rasmus Kupari,2021-22,Ontario Reign,AHL,15,5,3,8,12,2
Rasmus Kupari,2022-23,Los Angeles Kings,NHL,66,3,12,15,12,-5
Rasmus Kupari,2022-23,Ontario Reign,AHL,11,5,4,9,22,3
Rasmus Kupari,2023-24,Winnipeg Jets,NHL,28,0,1,1,4,-5
Rasmus Kupari,2023-24,Manitoba Moose,AHL,1,0,0,0,0,-2
Rasmus Kupari,2024-25,Winnipeg Jets,NHL,52,5,2,7,16,-2
Grigori Denisenko,2016-17,Yaroslavl Loko Jr.,Rus-MHL,28,9,13,22,20,16
Grigori Denisenko,2017-18,Yaroslavl Loko Jr.,Rus-MHL,31,9,13,22,30,8
Grigori Denisenko,2017-18,Yaroslavl Lokomotiv,KHL,--,--,--,--,--,--
Grigori Denisenko,2018-19,Yaroslavl Loko Jr.,Rus-MHL,4,1,2,3,0,3
Grigori Denisenko,2018-19,Tolyatti Lada,Rus-VHL,6,1,2,3,4,2
Grigori Denisenko,2018-19,Yaroslavl Lokomotiv,KHL,25,4,2,6,58,1
Grigori Denisenko,2019-20,Yaroslavl Lokomotiv,KHL,38,6,6,12,8,1
Grigori Denisenko,2020-21,Florida Panthers,NHL,7,0,4,4,2,1
Grigori Denisenko,2020-21,Syracuse Crunch,AHL,15,5,4,9,2,1
Grigori Denisenko,2021-22,Charlotte Checkers,AHL,30,9,9,18,8,-6
Grigori Denisenko,2021-22,Florida Panthers,NHL,1,0,0,0,2,0
Grigori Denisenko,2022-23,Florida Panthers,NHL,18,0,3,3,4,-5
Grigori Denisenko,2022-23,Charlotte Checkers,AHL,56,12,24,36,39,-18
Grigori Denisenko,2023-24,Vegas Golden Knights,NHL,6,0,0,0,2,-3
Grigori Denisenko,2023-24,Henderson Silver Knights,AHL,65,20,36,56,50,-17
Grigori Denisenko,2024-25,Vegas Golden Knights*,NHL,1,0,0,0,2,0
Grigori Denisenko,2024-25,Henderson Silver Knights*,AHL,42,10,14,24,36,-21
Grigori Denisenko,2024-25,Milwaukee Admirals,AHL,2,0,0,0,17,-1
Fraser Minten,2019-20,Prince George Spruce Kings,BCHL,2,0,0,0,0,
Fraser Minten,2020-21,Kamloops Blazers,WHL,20,4,14,18,12,4
Fraser Minten,2021-22,Kamloops Blazers,WHL,67,20,35,55,57,23
Fraser Minten,2022-23,Kamloops Blazers,WHL,57,31,36,67,55,24
Fraser Minten,2023-24,Kamloops Blazers,WHL,7,3,7,10,4,-2
Fraser Minten,2023-24,Toronto Maple Leafs,NHL,4,0,0,0,2,
Fraser Minten,2023-24,Saskatoon Blades,WHL,36,19,19,38,21,20
Fraser Minten,2024-25,Toronto Maple Leafs*,NHL,15,2,2,4,0,-4
Fraser Minten,2024-25,Toronto Marlies,AHL,21,5,5,10,6,-8
Travis Hamonic,2006-07,Moose Jaw Warriors,WHL,22,0,3,3,30,-2
Travis Hamonic,2006-07,Winnipeg Saints,MJHL,32,2,13,15,62,
Travis Hamonic,2007-08,Moose Jaw Warriors,WHL,61,5,17,22,101,5
Travis Hamonic,2008-09,Moose Jaw Warriors,WHL,57,13,27,40,126,-31
Travis Hamonic,2009-10,Moose Jaw Warriors,WHL,31,10,29,39,48,6
Travis Hamonic,2009-10,Brandon Wheat Kings,WHL,10,1,4,5,17,6
Travis Hamonic,2010-11,Bridgeport Sound Tigers,AHL,19,2,5,7,45,-6
Travis Hamonic,2010-11,New York Islanders,NHL,62,5,21,26,103,4
Travis Hamonic,2011-12,New York Islanders,NHL,73,2,22,24,73,6
Travis Hamonic,2012-13,Bridgeport Sound Tigers,AHL,21,4,6,10,37,-2
Travis Hamonic,2012-13,New York Islanders,NHL,48,3,7,10,28,-8
Travis Hamonic,2013-14,New York Islanders,NHL,69,3,15,18,68,2
Travis Hamonic,2014-15,New York Islanders,NHL,71,5,28,33,85,15
Travis Hamonic,2015-16,New York Islanders,NHL,72,5,16,21,35,-5
Travis Hamonic,2016-17,New York Islanders,NHL,49,3,11,14,60,-21
Travis Hamonic,2017-18,Calgary Flames,NHL,74,1,10,11,79,-9
Travis Hamonic,2018-19,Calgary Flames,NHL,69,7,12,19,33,21
Travis Hamonic,2019-20,Calgary Flames,NHL,50,3,9,12,27,-3
Travis Hamonic,2020-21,Vancouver Canucks,NHL,38,3,7,10,39,-3
Travis Hamonic,2021-22,Vancouver Canucks,NHL,24,3,4,7,6,1
Travis Hamonic,2021-22,Abbotsford Canucks,AHL,2,0,1,1,4,-2
Travis Hamonic,2021-22,Ottawa Senators,NHL,19,1,2,3,8,5
Travis Hamonic,2022-23,Ottawa Senators,NHL,75,6,15,21,71,-5
Travis Hamonic,2023-24,Ottawa Senators,NHL,48,2,4,6,40,-10
Travis Hamonic,2024-25,Ottawa Senators,NHL,45,0,3,3,17,-11
Casey Mittelstadt,2015-16,U.S. National Under-18 Team,USHL,2,2,0,2,2,1
Casey Mittelstadt,2016-17,Green Bay Gamblers,USHL,24,13,17,30,2,3
Casey Mittelstadt,2017-18,U. of Minnesota,Big-10,34,11,19,30,10,4
Casey Mittelstadt,2017-18,Buffalo Sabres,NHL,6,1,4,5,2,1
Casey Mittelstadt,2018-19,Buffalo Sabres,NHL,77,12,13,25,10,-19
Casey Mittelstadt,2019-20,Buffalo Sabres,NHL,31,4,5,9,2,-5
Casey Mittelstadt,2019-20,Rochester Americans,AHL,36,9,16,25,6,-15
Casey Mittelstadt,2020-21,Buffalo Sabres,NHL,41,10,12,22,10,-10
Casey Mittelstadt,2021-22,Buffalo Sabres,NHL,40,6,13,19,4,-14
Casey Mittelstadt,2022-23,Buffalo Sabres,NHL,82,15,44,59,22,-8
Casey Mittelstadt,2023-24,Buffalo Sabres,NHL,62,14,33,47,28,12
Casey Mittelstadt,2023-24,Colorado Avalanche,NHL,18,4,6,10,4,-2
Casey Mittelstadt,2024-25,Colorado Avalanche,NHL,57,9,23,32,18,-13
Connor Bedard,2020-21,Regina Pats,WHL,15,12,16,28,6,9
Connor Bedard,2020-21,HV71 Jr.,Swe-Jr,4,2,2,4,0,-3
Connor Bedard,2021-22,Regina Pats,WHL,62,51,49,100,42,0
Connor Bedard,2022-23,Regina Pats,WHL,57,71,72,143,62,39
Connor Bedard,2023-24,Chicago Blackhawks,NHL,68,22,39,61,28,-44
Connor Bedard,2024-25,Chicago Blackhawks,NHL,55,16,33,49,30,-22
Beck Malenstyn,2013-14,Calgary Hitmen,WHL,5,0,3,3,4,4
Beck Malenstyn,2014-15,Calgary Hitmen,WHL,51,8,4,12,25,1
Beck Malenstyn,2015-16,Calgary Hitmen,WHL,70,8,17,25,47,0
Beck Malenstyn,2016-17,Calgary Hitmen,WHL,70,32,24,56,60,-13
Beck Malenstyn,2017-18,Calgary Hitmen,WHL,4,0,3,3,0,2
Beck Malenstyn,2017-18,Swift Current Broncos üèÜ,WHL,38,17,12,29,28,10
Beck Malenstyn,2018-19,Hershey Bears,AHL,74,7,9,16,66,0
Beck Malenstyn,2019-20,Hershey Bears,AHL,46,7,8,15,20,5
Beck Malenstyn,2019-20,Washington Capitals,NHL,3,0,0,0,0,-1
Beck Malenstyn,2021-22,Washington Capitals,NHL,12,1,0,1,9,2
Beck Malenstyn,2021-22,Hershey Bears,AHL,65,10,6,16,20,-8
Beck Malenstyn,2022-23,Washington Capitals,NHL,9,1,1,2,2,0
Beck Malenstyn,2022-23,Hershey Bears üèÜ,AHL,40,6,4,10,23,1
Beck Malenstyn,2023-24,Washington Capitals,NHL,81,6,15,21,25,-1
Beck Malenstyn,2024-25,Buffalo Sabres,NHL,50,4,5,9,17,-8
Michael Eyssimont,2012-13,Fargo Force,USHL,4,0,0,0,0,-2
Michael Eyssimont,2013-14,Fargo Force,USHL,58,14,16,30,64,-16
Michael Eyssimont,2014-15,Fargo Force,USHL,46,17,19,36,46,3
Michael Eyssimont,2014-15,Sioux Falls Stampede üèÜ,USHL,14,5,8,13,16,3
Michael Eyssimont,2015-16,St. Cloud State,NCHC,40,14,19,33,20,14
Michael Eyssimont,2016-17,St. Cloud State,NCHC,36,14,16,30,20,-8
Michael Eyssimont,2017-18,St. Cloud State,NCHC,39,17,22,39,30,12
Michael Eyssimont,2017-18,Ontario Reign,AHL,3,0,1,1,0,1
Michael Eyssimont,2018-19,Ontario Reign,AHL,63,10,10,20,47,-11
Michael Eyssimont,2019-20,Ontario Reign,AHL,56,12,16,28,70,0
Michael Eyssimont,2020-21,Ontario Reign,AHL,40,9,8,17,49,-7
Michael Eyssimont,2021-22,Manitoba Moose,AHL,58,18,24,42,90,15
Michael Eyssimont,2021-22,Winnipeg Jets,NHL,1,0,0,0,0,0
Michael Eyssimont,2022-23,Winnipeg Jets,NHL,19,1,4,5,7,5
Michael Eyssimont,2022-23,Manitoba Moose,AHL,9,2,7,9,27,8
Michael Eyssimont,2022-23,San Jose Sharks,NHL,20,3,5,8,34,1
Michael Eyssimont,2022-23,Tampa Bay Lightning,NHL,15,1,1,2,22,-3
Michael Eyssimont,2023-24,Tampa Bay Lightning,NHL,81,11,14,25,104,7
Michael Eyssimont,2024-25,Tampa Bay Lightning,NHL,51,4,4,8,42,-3
Conor Timmins,2014-15,St. Catharines Falcons,GOJHL,15,5,3,8,13,
Conor Timmins,2014-15,Thorold Blackhawks,GOJHL,15,2,8,10,28,
Conor Timmins,2015-16,Soo Greyhounds,OHL,60,4,9,13,20,27
Conor Timmins,2016-17,Soo Greyhounds,OHL,67,7,54,61,69,53
Conor Timmins,2017-18,Soo Greyhounds,OHL,36,8,33,41,43,18
Conor Timmins,2018-19,Did Not Play,Ind,--,Statistics Unavailable,,,,
Conor Timmins,2019-20,Colorado Avalanche,NHL,2,0,0,0,0,2
Conor Timmins,2019-20,Colorado Eagles,AHL,40,3,24,27,38,-1
Conor Timmins,2020-21,Colorado Avalanche,NHL,31,0,7,7,8,6
Conor Timmins,2020-21,Colorado Eagles,AHL,6,1,3,4,4,-3
Conor Timmins,2021-22,Arizona Coyotes,NHL,6,0,0,0,0,-6
Conor Timmins,2022-23,Arizona Coyotes,NHL,2,0,0,0,0,-2
Conor Timmins,2022-23,Tucson Roadrunners,AHL,6,0,3,3,12,-10
Conor Timmins,2022-23,Toronto Maple Leafs,NHL,25,2,12,14,8,1
Conor Timmins,2023-24,Toronto Maple Leafs,NHL,25,1,9,10,18,9
Conor Timmins,2024-25,Toronto Maple Leafs,NHL,44,1,6,7,22,1
Adam Boqvist,2016-17,Brynas Jr.,Swe-Jr,18,4,12,16,10,1
Adam Boqvist,2017-18,Brynas Jr.,Swe-Jr,25,14,10,24,18,6
Adam Boqvist,2017-18,Brynas IF Gavle,SweHL,15,0,1,1,4,-7
Adam Boqvist,2017-18,Almtuna IS,Swe-1,7,0,2,2,2,1
Adam Boqvist,2018-19,London Knights,OHL,54,20,40,60,12,12
Adam Boqvist,2019-20,Rockford IceHogs,AHL,15,1,5,6,10,2
Adam Boqvist,2019-20,Chicago Blackhawks,NHL,41,4,9,13,6,-3
Adam Boqvist,2020-21,Chicago Blackhawks,NHL,35,2,14,16,14,-7
Adam Boqvist,2021-22,Columbus Blue Jackets,NHL,52,11,11,22,12,-11
Adam Boqvist,2022-23,Columbus Blue Jackets,NHL,46,5,19,24,8,-12
Adam Boqvist,2023-24,Columbus Blue Jackets,NHL,35,1,9,10,0,-8
Adam Boqvist,2024-25,Florida Panthers*,NHL,18,2,4,6,6,-4
Adam Boqvist,2024-25,New York Islanders,NHL,5,1,0,1,0,0
Jakob Chychrun,2014-15,Sarnia Sting,OHL,42,16,17,33,37,-11
Jakob Chychrun,2015-16,Sarnia Sting,OHL,62,11,38,49,51,23
Jakob Chychrun,2016-17,Arizona Coyotes,NHL,68,7,13,20,47,-14
Jakob Chychrun,2017-18,Arizona Coyotes,NHL,50,4,10,14,16,2
Jakob Chychrun,2018-19,Arizona Coyotes,NHL,53,5,15,20,28,-12
Jakob Chychrun,2019-20,Arizona Coyotes,NHL,63,12,14,26,38,4
Jakob Chychrun,2020-21,Arizona Coyotes,NHL,56,18,23,41,42,-6
Jakob Chychrun,2021-22,Arizona Coyotes,NHL,47,7,14,21,47,-20
Jakob Chychrun,2022-23,Arizona Coyotes,NHL,36,7,21,28,22,8
Jakob Chychrun,2022-23,Ottawa Senators,NHL,12,2,3,5,8,-1
Jakob Chychrun,2023-24,Ottawa Senators,NHL,82,14,27,41,60,-30
Jakob Chychrun,2024-25,Washington Capitals,NHL,51,16,21,37,34,23
Oliver Ekman-Larsson,2008-09,Leksands IF,Swe-1,39,3,14,17,32,44
Oliver Ekman-Larsson,2009-10,Leksands IF,Swe-1,42,9,18,27,98,19
Oliver Ekman-Larsson,2010-11,Phoenix Coyotes,NHL,48,1,10,11,24,3
Oliver Ekman-Larsson,2010-11,San Antonio Rampage,AHL,15,3,7,10,16,-3
Oliver Ekman-Larsson,2011-12,Phoenix Coyotes,NHL,82,13,19,32,32,0
Oliver Ekman-Larsson,2012-13,Portland Pirates,AHL,20,7,14,21,28,5
Oliver Ekman-Larsson,2012-13,Phoenix Coyotes,NHL,48,3,21,24,26,5
Oliver Ekman-Larsson,2013-14,Phoenix Coyotes,NHL,80,15,29,44,50,-4
Oliver Ekman-Larsson,2014-15,Arizona Coyotes,NHL,82,23,20,43,40,-18
Oliver Ekman-Larsson,2015-16,Arizona Coyotes,NHL,75,21,34,55,96,-6
Oliver Ekman-Larsson,2016-17,Arizona Coyotes,NHL,79,12,27,39,48,-25
Oliver Ekman-Larsson,2017-18,Arizona Coyotes,NHL,82,14,28,42,44,-28
Oliver Ekman-Larsson,2018-19,Arizona Coyotes,NHL,81,14,30,44,52,-16
Oliver Ekman-Larsson,2019-20,Arizona Coyotes,NHL,66,9,21,30,38,-3
Oliver Ekman-Larsson,2020-21,Arizona Coyotes,NHL,46,3,21,24,32,-17
Oliver Ekman-Larsson,2021-22,Vancouver Canucks,NHL,79,5,24,29,52,5
Oliver Ekman-Larsson,2022-23,Vancouver Canucks,NHL,54,2,20,22,22,-24
Oliver Ekman-Larsson,2023-24,Florida Panthers üèÜ,NHL,80,9,23,32,76,10
Oliver Ekman-Larsson,2024-25,Toronto Maple Leafs,NHL,54,3,19,22,40,17
Dylan McIlrath,2008-09,Moose Jaw Warriors,WHL,53,1,3,4,102,-22
Dylan McIlrath,2009-10,Moose Jaw Warriors,WHL,65,7,17,24,169,20
Dylan McIlrath,2010-11,Moose Jaw Warriors,WHL,62,5,18,23,153,0
Dylan McIlrath,2010-11,Hartford Wolf Pack/CT Whale,AHL,2,0,0,0,7,-1
Dylan McIlrath,2011-12,Moose Jaw Warriors,WHL,52,3,20,23,127,7
Dylan McIlrath,2011-12,Connecticut Whale,AHL,--,--,--,--,--,--
Dylan McIlrath,2012-13,Connecticut Whale,AHL,45,0,5,5,125,7
Dylan McIlrath,2013-14,Hartford Wolf Pack,AHL,62,6,11,17,165,2
Dylan McIlrath,2013-14,New York Rangers,NHL,2,0,0,0,7,-1
Dylan McIlrath,2014-15,Hartford Wolf Pack,AHL,73,6,11,17,165,5
Dylan McIlrath,2014-15,New York Rangers,NHL,1,0,0,0,9,0
Dylan McIlrath,2015-16,New York Rangers,NHL,34,2,2,4,64,7
Dylan McIlrath,2016-17,New York Rangers,NHL,1,0,0,0,4,0
Dylan McIlrath,2016-17,Hartford Wolf Pack,AHL,4,0,0,0,11,-3
Dylan McIlrath,2016-17,Florida Panthers,NHL,5,1,0,1,10,-2
Dylan McIlrath,2016-17,Springfield Thunderbirds,AHL,18,1,3,4,28,0
Dylan McIlrath,2016-17,Grand Rapids Griffins üèÜ,AHL,21,0,4,4,42,-3
Dylan McIlrath,2017-18,Grand Rapids Griffins,AHL,76,7,10,17,119,8
Dylan McIlrath,2018-19,Grand Rapids Griffins,AHL,52,1,9,10,98,13
Dylan McIlrath,2018-19,Detroit Red Wings,NHL,7,0,0,0,4,2
Dylan McIlrath,2019-20,Grand Rapids Griffins,AHL,44,0,8,8,73,-5
Dylan McIlrath,2019-20,Detroit Red Wings,NHL,16,0,0,0,23,-4
Dylan McIlrath,2020-21,Grand Rapids Griffins,AHL,29,2,6,8,70,2
Dylan McIlrath,2021-22,Hershey Bears,AHL,74,4,6,10,99,4
Dylan McIlrath,2022-23,Washington Capitals,NHL,6,0,1,1,7,-6
Dylan McIlrath,2022-23,Hershey Bears üèÜ,AHL,60,0,13,13,102,6
Dylan McIlrath,2023-24,Washington Capitals,NHL,3,0,1,1,5,1
Dylan McIlrath,2023-24,Hershey Bears üèÜ,AHL,58,3,6,9,100,6
Dylan McIlrath,2024-25,Washington Capitals,NHL,11,0,2,2,14,1
Colton Dach,2019-20,Saskatoon Blades,WHL,62,11,18,29,45,7
Colton Dach,2020-21,Saskatoon Blades,WHL,20,11,9,20,16,0
Colton Dach,2021-22,Kelowna Rockets,WHL,61,29,50,79,53,25
Colton Dach,2022-23,Kelowna Rockets,WHL,14,9,8,17,23,9
Colton Dach,2022-23,Seattle Thunderbirds üèÜ,WHL,9,3,7,10,8,2
Colton Dach,2023-24,Rockford IceHogs,AHL,48,11,16,27,39,6
Colton Dach,2024-25,Chicago Blackhawks*,NHL,13,1,3,4,4,0
Colton Dach,2024-25,Rockford IceHogs,AHL,32,12,14,26,21,-7
Matt Rempe,2018-19,Spruce Grove Saints,AJHL,43,4,8,12,32,
Matt Rempe,2019-20,Seattle Thunderbirds,WHL,47,12,19,31,53,-1
Matt Rempe,2020-21,Spruce Grove Saints,AJHL,2,0,0,0,2,
Matt Rempe,2020-21,Seattle Thunderbirds,WHL,8,1,4,5,12,0
Matt Rempe,2021-22,Seattle Thunderbirds,WHL,56,17,6,23,93,-7
Matt Rempe,2022-23,Hartford Wolf Pack,AHL,53,6,4,10,87,0
Matt Rempe,2023-24,Hartford Wolf Pack,AHL,43,8,4,12,96,-9
Matt Rempe,2023-24,New York Rangers,NHL,17,1,1,2,71,1
Matt Rempe,2024-25,Hartford Wolf Pack*,AHL,18,3,2,5,22,-3
Matt Rempe,2024-25,New York Rangers,NHL,20,1,2,3,39,4
Nick Perbix,2017-18,Omaha Lancers,USHL,56,4,25,29,38,19
Nick Perbix,2018-19,St. Cloud State,NCHC,39,5,15,20,16,24
Nick Perbix,2019-20,St. Cloud State,NCHC,34,4,11,15,25,-12
Nick Perbix,2020-21,St. Cloud State,NCHC,31,7,16,23,16,8
Nick Perbix,2021-22,St. Cloud State,NCHC,31,6,25,31,14,3
Nick Perbix,2021-22,Syracuse Crunch,AHL,12,2,6,8,2,0
Nick Perbix,2022-23,Tampa Bay Lightning,NHL,69,5,15,20,22,11
Nick Perbix,2022-23,Syracuse Crunch,AHL,2,0,0,0,0,-3
Nick Perbix,2023-24,Tampa Bay Lightning,NHL,77,2,22,24,10,8
Nick Perbix,2024-25,Tampa Bay Lightning,NHL,50,4,10,14,16,5
Pavel Zacha,2013-14,Liberec Bili Tygri HC,Czech,38,4,4,8,10,-2
Pavel Zacha,2014-15,Sarnia Sting,OHL,37,16,18,34,56,5
Pavel Zacha,2015-16,Sarnia Sting,OHL,51,28,36,64,97,17
Pavel Zacha,2015-16,New Jersey Devils,NHL,1,0,2,2,0,4
Pavel Zacha,2015-16,Albany Devils,AHL,3,1,2,3,2,3
Pavel Zacha,2016-17,New Jersey Devils,NHL,70,8,16,24,19,-17
Pavel Zacha,2017-18,New Jersey Devils,NHL,69,8,17,25,30,-3
Pavel Zacha,2018-19,New Jersey Devils,NHL,61,13,12,25,15,-6
Pavel Zacha,2018-19,Binghamton Devils,AHL,4,0,5,5,2,2
Pavel Zacha,2019-20,New Jersey Devils,NHL,65,8,24,32,14,-12
Pavel Zacha,2020-21,New Jersey Devils,NHL,50,17,18,35,10,-11
Pavel Zacha,2021-22,New Jersey Devils,NHL,70,15,21,36,22,-21
Pavel Zacha,2022-23,Boston Bruins,NHL,82,21,36,57,16,26
Pavel Zacha,2023-24,Boston Bruins,NHL,78,21,38,59,18,12
Pavel Zacha,2024-25,Boston Bruins,NHL,57,12,21,33,19,4
Esa Lindell,2011-12,Kiekko-Vanta,Mestis,2,0,0,0,0,1
Esa Lindell,2012-13,Kiekko-Vanta,Mestis,22,4,6,10,16,-10
Esa Lindell,2012-13,Jokerit Helsinki,SM-liiga,19,0,0,0,4,-9
Esa Lindell,2013-14,Kiekko-Vanta,Mestis,11,2,3,5,8,2
Esa Lindell,2013-14,Jokerit Helsinki,SM-liiga,44,2,3,5,10,8
Esa Lindell,2014-15,Assat Pori,SM-liiga,57,14,21,35,28,0
Esa Lindell,2014-15,Texas Stars,AHL,5,0,1,1,2,0
Esa Lindell,2015-16,Texas Stars,AHL,73,14,28,42,56,6
Esa Lindell,2015-16,Dallas Stars,NHL,4,0,0,0,0,-3
Esa Lindell,2016-17,Dallas Stars,NHL,73,6,12,18,22,8
Esa Lindell,2016-17,Texas Stars,AHL,2,0,1,1,0,3
Esa Lindell,2017-18,Dallas Stars,NHL,80,7,20,27,24,19
Esa Lindell,2018-19,Dallas Stars,NHL,82,11,21,32,33,14
Esa Lindell,2019-20,Dallas Stars,NHL,69,3,20,23,12,5
Esa Lindell,2020-21,Dallas Stars,NHL,56,5,11,16,19,11
Esa Lindell,2021-22,Dallas Stars,NHL,76,4,21,25,12,4
Esa Lindell,2022-23,Dallas Stars,NHL,82,8,16,24,10,29
Esa Lindell,2023-24,Dallas Stars,NHL,82,5,21,26,12,17
Esa Lindell,2024-25,Dallas Stars,NHL,55,4,15,19,12,22
Nikita Chibrikov,2019-20,Moscow Dynamo Jr.,Rus-MHL,32,3,13,16,8,2
Nikita Chibrikov,2020-21,Neva SKA,Rus-VHL,20,3,5,8,49,-7
Nikita Chibrikov,2020-21,St. Petersburg SKA,KHL,16,1,1,2,6,0
Nikita Chibrikov,2020-21,St. Petersburg SKA Jr.,Rus-MHL,11,3,6,9,12,2
Nikita Chibrikov,2021-22,Neva SKA,Rus-VHL,28,15,16,31,10,17
Nikita Chibrikov,2021-22,St. Petersburg SKA Jr.,Rus-MHL,4,4,2,6,8,7
Nikita Chibrikov,2021-22,St. Petersburg SKA,KHL,4,0,0,0,0,-3
Nikita Chibrikov,2022-23,Moscow Spartak,KHL,31,1,1,2,10,-7
Nikita Chibrikov,2022-23,Voskresensk Khimik,Rus-VHL,16,3,7,10,4,3
Nikita Chibrikov,2022-23,Moscow Spartak Jr.,Rus-MHL,12,8,10,18,2,9
Nikita Chibrikov,2023-24,Winnipeg Jets,NHL,1,1,0,1,0,
Nikita Chibrikov,2023-24,Manitoba Moose,AHL,70,17,30,47,53,-18
Nikita Chibrikov,2024-25,Winnipeg Jets*,NHL,4,2,1,3,0,1
Nikita Chibrikov,2024-25,Manitoba Moose,AHL,30,7,11,18,10,-15
Jordan Kyrou,2014-15,Sarnia Sting,OHL,63,13,23,36,12,8
Jordan Kyrou,2015-16,Sarnia Sting,OHL,65,17,34,51,14,13
Jordan Kyrou,2016-17,Sarnia Sting,OHL,66,30,64,94,36,5
Jordan Kyrou,2016-17,Chicago Wolves,AHL,1,0,0,0,0,0
Jordan Kyrou,2017-18,Sarnia Sting,OHL,56,39,70,109,22,26
Jordan Kyrou,2018-19,St. Louis Blues,NHL,16,1,2,3,4,-1
Jordan Kyrou,2018-19,San Antonio Rampage,AHL,47,16,27,43,10,1
Jordan Kyrou,2019-20,St. Louis Blues,NHL,28,4,5,9,8,1
Jordan Kyrou,2019-20,San Antonio Rampage,AHL,16,9,6,15,10,5
Jordan Kyrou,2020-21,St. Louis Blues,NHL,55,14,21,35,12,1
Jordan Kyrou,2021-22,St. Louis Blues,NHL,74,27,48,75,20,10
Jordan Kyrou,2022-23,St. Louis Blues,NHL,79,37,36,73,22,-38
Jordan Kyrou,2023-24,St. Louis Blues,NHL,82,31,36,67,22,-12
Jordan Kyrou,2024-25,St. Louis Blues,NHL,56,23,21,44,10,10
Oliver Wahlstrom,2016-17,U.S. National Under-18 Team,USHL,8,4,1,5,4,-5
Oliver Wahlstrom,2016-17,U.S. National Under-17 Team,USHL,21,5,3,8,10,-8
Oliver Wahlstrom,2017-18,U.S. National Under-18 Team,USHL,26,22,23,45,22,30
Oliver Wahlstrom,2017-18,U.S. National Under-18 Team,Exhibition,36,26,23,49,20,7
Oliver Wahlstrom,2018-19,Boston College,H-East,36,8,11,19,28,-6
Oliver Wahlstrom,2018-19,Bridgeport Sound Tigers,AHL,5,2,1,3,9,-3
Oliver Wahlstrom,2019-20,Bridgeport Sound Tigers,AHL,45,10,12,22,29,-16
Oliver Wahlstrom,2019-20,New York Islanders,NHL,9,0,0,0,4,-2
Oliver Wahlstrom,2020-21,AIK,Swe-1,10,4,4,8,8,-2
Oliver Wahlstrom,2020-21,New York Islanders,NHL,44,12,9,21,21,2
Oliver Wahlstrom,2021-22,New York Islanders,NHL,73,13,11,24,74,-6
Oliver Wahlstrom,2022-23,New York Islanders,NHL,35,7,9,16,32,5
Oliver Wahlstrom,2023-24,New York Islanders,NHL,32,2,4,6,8,-6
Oliver Wahlstrom,2024-25,New York Islanders*,NHL,27,2,2,4,9,-6
Oliver Wahlstrom,2024-25,Boston Bruins,NHL,15,1,1,2,26,0
Shakir Mukhamadullin,2018-19,Ufa Tolpar,Rus-MHL,5,1,2,3,2,4
Shakir Mukhamadullin,2019-20,Ufa Tolpar,Rus-MHL,13,2,8,10,6,13
Shakir Mukhamadullin,2019-20,Neftekamsk Toros,Rus-VHL,1,0,0,0,0,-1
Shakir Mukhamadullin,2019-20,Ufa Salavat Yulayev,KHL,27,0,1,1,0,-1
Shakir Mukhamadullin,2020-21,Ufa Salavat Yulayev,KHL,39,3,7,10,10,-2
Shakir Mukhamadullin,2021-22,Ufa Salavat Yulayev,KHL,34,3,4,7,12,0
Shakir Mukhamadullin,2021-22,Utica Comets,AHL,--,--,--,--,--,--
Shakir Mukhamadullin,2022-23,Ufa Salavat Yulayev,KHL,67,6,19,25,23,16
Shakir Mukhamadullin,2022-23,San Jose Barracuda,AHL,12,1,9,10,6,1
Shakir Mukhamadullin,2023-24,San Jose Barracuda,AHL,55,7,27,34,24,3
Shakir Mukhamadullin,2023-24,San Jose Sharks,NHL,3,0,1,1,4,
Shakir Mukhamadullin,2024-25,San Jose Barracuda*,AHL,21,0,9,9,6,-6
Shakir Mukhamadullin,2024-25,San Jose Sharks,NHL,13,1,0,1,2,-1
Gage Goncalves,2017-18,Chilliwack Chiefs,BCHL,4,1,1,2,4,
Gage Goncalves,2017-18,Everett Silvertips,WHL,1,0,0,0,2,0
Gage Goncalves,2018-19,Everett Silvertips,WHL,67,1,14,15,26,10
Gage Goncalves,2019-20,Everett Silvertips,WHL,60,33,38,71,44,32
Gage Goncalves,2020-21,Syracuse Crunch,AHL,2,0,1,1,0,-3
Gage Goncalves,2020-21,Everett Silvertips,WHL,23,12,22,34,12,17
Gage Goncalves,2021-22,Syracuse Crunch,AHL,70,17,15,32,39,-2
Gage Goncalves,2022-23,Syracuse Crunch,AHL,71,13,41,54,34,6
Gage Goncalves,2023-24,Syracuse Crunch,AHL,69,13,45,58,43,-8
Gage Goncalves,2023-24,Tampa Bay Lightning,NHL,2,0,0,0,6,
Gage Goncalves,2024-25,Syracuse Crunch*,AHL,14,5,13,18,10,-5
Gage Goncalves,2024-25,Tampa Bay Lightning,NHL,33,1,6,7,4,3
Colin Blackwell,2011-12,Harvard University,ECAC,34,5,14,19,46,
Colin Blackwell,2012-13,Harvard University,ECAC,21,3,11,14,10,
Colin Blackwell,2014-15,Harvard University,ECAC,11,5,1,6,6,1
Colin Blackwell,2015-16,Harvard University,ECAC,28,6,13,19,12,6
Colin Blackwell,2016-17,San Jose Barracuda,AHL,57,4,7,11,24,-7
Colin Blackwell,2017-18,Rochester Americans,AHL,61,17,28,45,23,15
Colin Blackwell,2018-19,Milwaukee Admirals,AHL,43,14,12,26,22,-12
Colin Blackwell,2018-19,Nashville Predators,NHL,6,0,0,0,2,-1
Colin Blackwell,2019-20,Milwaukee Admirals,AHL,26,6,17,23,21,14
Colin Blackwell,2019-20,Nashville Predators,NHL,27,3,7,10,10,7
Colin Blackwell,2020-21,New York Rangers,NHL,47,12,10,22,15,2
Colin Blackwell,2021-22,Seattle Kraken,NHL,39,8,9,17,4,1
Colin Blackwell,2021-22,Toronto Maple Leafs,NHL,19,2,1,3,10,-1
Colin Blackwell,2022-23,Chicago Blackhawks,NHL,53,2,8,10,6,-16
Colin Blackwell,2023-24,Chicago Blackhawks,NHL,44,8,4,12,10,-2
Colin Blackwell,2024-25,Dallas Stars,NHL,48,5,8,13,10,2
Jack Finley,2017-18,Penticton Vees,BCHL,2,1,0,1,0,
Jack Finley,2017-18,Spokane Chiefs,WHL,7,0,1,1,8,0
Jack Finley,2018-19,Spokane Chiefs,WHL,63,9,10,19,44,-6
Jack Finley,2019-20,Spokane Chiefs,WHL,61,19,38,57,32,32
Jack Finley,2020-21,Syracuse Crunch,AHL,2,0,0,0,0,-1
Jack Finley,2020-21,Spokane Chiefs,WHL,1,0,0,0,0,0
Jack Finley,2021-22,Spokane Chiefs,WHL,21,8,8,16,40,-4
Jack Finley,2021-22,Winnipeg Ice,WHL,39,19,15,34,28,5
Jack Finley,2022-23,Syracuse Crunch,AHL,67,12,9,21,49,2
Jack Finley,2023-24,Syracuse Crunch,AHL,52,13,19,32,29,
Jack Finley,2024-25,Tampa Bay Lightning*,NHL,1,0,0,0,0,1
Jack Finley,2024-25,Syracuse Crunch,AHL,22,5,7,12,6,8
Steven Lorentz,2011-12,Waterloo Siskins,GOJHL,1,0,0,0,0,
Steven Lorentz,2012-13,Waterloo Siskins,GOJHL,3,0,0,0,2,
Steven Lorentz,2013-14,Peterborough Petes,OHL,64,7,11,18,18,-4
Steven Lorentz,2014-15,Peterborough Petes,OHL,59,16,21,37,15,-1
Steven Lorentz,2015-16,Peterborough Petes,OHL,58,23,25,48,27,10
Steven Lorentz,2016-17,Peterborough Petes,OHL,66,29,32,61,37,12
Steven Lorentz,2017-18,Florida Everblades,ECHL,62,12,23,35,34,8
Steven Lorentz,2017-18,Charlotte Checkers,AHL,3,0,0,0,0,-2
Steven Lorentz,2018-19,Florida Everblades,ECHL,22,10,18,28,11,17
Steven Lorentz,2018-19,Charlotte Checkers üèÜ,AHL,29,3,6,9,23,3
Steven Lorentz,2019-20,Charlotte Checkers,AHL,61,23,23,46,37,23
Steven Lorentz,2020-21,Carolina Hurricanes,NHL,45,2,6,8,8,1
Steven Lorentz,2021-22,Carolina Hurricanes,NHL,67,8,5,13,8,0
Steven Lorentz,2022-23,San Jose Sharks,NHL,80,10,9,19,16,-18
Steven Lorentz,2023-24,Florida Panthers üèÜ,NHL,38,1,2,3,10,-9
Steven Lorentz,2024-25,Toronto Maple Leafs,NHL,55,5,7,12,4,3
Daniil Miromanov,2014-15,Orangeville Flyers,OJHL,1,0,0,0,0,
Daniil Miromanov,2015-16,Acadie-Bathurst Titan,QMJHL,64,22,20,42,18,-6
Daniil Miromanov,2016-17,Acadie-Bathurst Titan,QMJHL,68,22,40,62,20,6
Daniil Miromanov,2017-18,Penza Dizelist,Rus-VHL,10,1,1,2,6,
Daniil Miromanov,2017-18,Sochi HC,KHL,15,0,0,0,2,-2
Daniil Miromanov,2017-18,Moncton Wildcats,QMJHL,38,8,24,32,12,-14
Daniil Miromanov,2018-19,Pardubice HC,Czech,16,1,3,4,8,-4
Daniil Miromanov,2018-19,Manchester Monarchs,ECHL,49,13,27,40,26,15
Daniil Miromanov,2019-20,Neva SKA,Rus-VHL,43,9,13,22,22,20
Daniil Miromanov,2020-21,Henderson Silver Knights,AHL,6,0,0,0,2,1
Daniil Miromanov,2020-21,Sochi HC,KHL,58,10,19,29,16,-20
Daniil Miromanov,2021-22,Vegas Golden Knights,NHL,11,0,1,1,2,0
Daniil Miromanov,2021-22,Henderson Silver Knights,AHL,53,11,29,40,30,11
Daniil Miromanov,2022-23,Vegas Golden Knights,NHL,14,2,4,6,2,-6
Daniil Miromanov,2022-23,Henderson Silver Knights,AHL,31,9,13,22,10,-9
Daniil Miromanov,2023-24,Vegas Golden Knights,NHL,4,0,0,0,0,-2
Daniil Miromanov,2023-24,Henderson Silver Knights,AHL,5,1,5,6,0,-2
Daniil Miromanov,2023-24,Calgary Flames,NHL,20,3,4,7,8,
Daniil Miromanov,2024-25,Calgary Flames,NHL,36,1,6,7,10,3
Danton Heinen,2012-13,Merritt Centennials,BCHL,2,0,2,2,0,
Danton Heinen,2013-14,Surrey Eagles,BCHL,57,29,33,62,8,
Danton Heinen,2014-15,U. of Denver,NCHC,40,16,29,45,10,19
Danton Heinen,2015-16,U. of Denver,NCHC,41,20,28,48,10,19
Danton Heinen,2015-16,Providence Bruins,AHL,2,0,2,2,2,1
Danton Heinen,2016-17,Boston Bruins,NHL,8,0,0,0,2,-3
Danton Heinen,2016-17,Providence Bruins,AHL,64,14,30,44,14,1
Danton Heinen,2017-18,Providence Bruins,AHL,4,1,7,8,2,5
Danton Heinen,2017-18,Boston Bruins,NHL,77,16,31,47,16,10
Danton Heinen,2018-19,Boston Bruins,NHL,77,11,23,34,16,13
Danton Heinen,2019-20,Boston Bruins,NHL,58,7,15,22,8,3
Danton Heinen,2019-20,Anaheim Ducks,NHL,9,3,1,4,2,-5
Danton Heinen,2020-21,Anaheim Ducks,NHL,43,7,7,14,0,-9
Danton Heinen,2021-22,Pittsburgh Penguins,NHL,76,18,15,33,16,6
Danton Heinen,2022-23,Pittsburgh Penguins,NHL,65,8,14,22,12,-5
Danton Heinen,2023-24,Boston Bruins,NHL,74,17,19,36,28,16
Danton Heinen,2024-25,Vancouver Canucks*,NHL,51,6,12,18,31,-1
Danton Heinen,2024-25,Pittsburgh Penguins,NHL,5,1,1,2,0,1
Kailer Yamamoto,2014-15,Spokane Chiefs,WHL,68,23,34,57,50,12
Kailer Yamamoto,2015-16,Spokane Chiefs,WHL,57,19,52,71,34,20
Kailer Yamamoto,2016-17,Spokane Chiefs,WHL,65,42,57,99,46,14
Kailer Yamamoto,2017-18,Edmonton Oilers,NHL,9,0,3,3,2,-2
Kailer Yamamoto,2017-18,Spokane Chiefs,WHL,40,21,43,64,18,22
Kailer Yamamoto,2018-19,Edmonton Oilers,NHL,17,1,1,2,2,-6
Kailer Yamamoto,2018-19,Bakersfield Condors,AHL,27,10,8,18,16,12
Kailer Yamamoto,2019-20,Bakersfield Condors,AHL,23,8,8,16,16,-7
Kailer Yamamoto,2019-20,Edmonton Oilers,NHL,27,11,15,26,12,17
Kailer Yamamoto,2020-21,Edmonton Oilers,NHL,52,8,13,21,26,9
Kailer Yamamoto,2021-22,Edmonton Oilers,NHL,81,20,21,41,40,-1
Kailer Yamamoto,2022-23,Edmonton Oilers,NHL,58,10,15,25,24,12
Kailer Yamamoto,2023-24,Seattle Kraken,NHL,59,8,8,16,18,-9
Kailer Yamamoto,2024-25,Utah Hockey Club*,NHL,3,0,0,0,0,-1
Kailer Yamamoto,2024-25,Tucson Roadrunners,AHL,39,14,26,40,20,9
John Tavares,2004-05,Milton Icehawks,OPJHL,16,11,12,23,8,
John Tavares,2005-06,Oshawa Generals,OHL,65,45,32,77,72,-13
John Tavares,2006-07,Oshawa Generals,OHL,67,72,62,134,60,25
John Tavares,2007-08,Oshawa Generals,OHL,59,40,78,118,69,22
John Tavares,2008-09,Oshawa Generals,OHL,32,26,28,54,32,5
John Tavares,2008-09,London Knights,OHL,24,32,18,50,22,5
John Tavares,2009-10,New York Islanders,NHL,82,24,30,54,22,-15
John Tavares,2010-11,New York Islanders,NHL,79,29,38,67,53,-16
John Tavares,2011-12,New York Islanders,NHL,82,31,50,81,26,-6
John Tavares,2012-13,Bern SC,Swiss-A,28,17,25,42,28,16
John Tavares,2012-13,New York Islanders,NHL,48,28,19,47,18,-2
John Tavares,2013-14,New York Islanders,NHL,59,24,42,66,40,-6
John Tavares,2014-15,New York Islanders,NHL,82,38,48,86,46,5
John Tavares,2015-16,New York Islanders,NHL,78,33,37,70,38,6
John Tavares,2016-17,New York Islanders,NHL,77,28,38,66,38,4
John Tavares,2017-18,New York Islanders,NHL,82,37,47,84,26,-12
John Tavares,2018-19,Toronto Maple Leafs,NHL,82,47,41,88,34,19
John Tavares,2019-20,Toronto Maple Leafs,NHL,63,26,34,60,24,-7
John Tavares,2020-21,Toronto Maple Leafs,NHL,56,19,31,50,14,12
John Tavares,2021-22,Toronto Maple Leafs,NHL,79,27,49,76,32,-8
John Tavares,2022-23,Toronto Maple Leafs,NHL,80,36,44,80,34,-7
John Tavares,2023-24,Toronto Maple Leafs,NHL,80,29,36,65,30,2
John Tavares,2024-25,Toronto Maple Leafs,NHL,48,21,24,45,28,5
Daemon Hunt,2017-18,Moose Jaw Warriors,WHL,9,1,1,2,2,4
Daemon Hunt,2018-19,Moose Jaw Warriors,WHL,57,7,13,20,10,21
Daemon Hunt,2019-20,Moose Jaw Warriors,WHL,28,0,15,15,17,-24
Daemon Hunt,2020-21,Virden Oil Capitals,MJHL,3,3,2,5,2,
Daemon Hunt,2020-21,Iowa Wild,AHL,6,1,0,1,0,0
Daemon Hunt,2020-21,Moose Jaw Warriors,WHL,23,8,10,18,11,-12
Daemon Hunt,2021-22,Moose Jaw Warriors,WHL,46,17,22,39,41,14
Daemon Hunt,2022-23,Iowa Wild,AHL,59,2,9,11,14,2
Daemon Hunt,2023-24,Minnesota Wild,NHL,12,0,1,1,0,-1
Daemon Hunt,2023-24,Iowa Wild,AHL,51,3,26,29,29,-4
Daemon Hunt,2024-25,Minnesota Wild*,NHL,1,0,0,0,0,0
Daemon Hunt,2024-25,Iowa Wild*,AHL,9,0,4,4,5,-1
Daemon Hunt,2024-25,Cleveland Monsters,AHL,29,2,10,12,12,-6
Noah Gregor,2014-15,Moose Jaw Warriors,WHL,10,2,4,6,0,4
Noah Gregor,2015-16,Moose Jaw Warriors,WHL,72,28,45,73,33,-2
Noah Gregor,2016-17,Moose Jaw Warriors,WHL,52,27,34,61,29,5
Noah Gregor,2017-18,Moose Jaw Warriors,WHL,30,14,22,36,27,14
Noah Gregor,2017-18,San Jose Barracuda,AHL,--,--,--,--,--,--
Noah Gregor,2017-18,Victoria Royals,WHL,30,15,14,29,29,-7
Noah Gregor,2018-19,Prince Albert Raiders üèÜ,WHL,63,43,45,88,38,49
Noah Gregor,2019-20,San Jose Sharks,NHL,28,3,2,5,8,-5
Noah Gregor,2019-20,San Jose Barracuda,AHL,25,7,12,19,15,-4
Noah Gregor,2020-21,San Jose Sharks,NHL,30,5,1,6,6,-16
Noah Gregor,2020-21,San Jose Barracuda,AHL,10,3,6,9,2,1
Noah Gregor,2021-22,San Jose Barracuda,AHL,8,4,8,12,7,2
Noah Gregor,2021-22,San Jose Sharks,NHL,63,8,15,23,25,-21
Noah Gregor,2022-23,San Jose Sharks,NHL,57,10,7,17,32,-9
Noah Gregor,2023-24,Toronto Maple Leafs,NHL,63,6,6,12,17,-7
Noah Gregor,2024-25,Ottawa Senators,NHL,35,4,2,6,17,-10
Marc Del Gaizo,2015-16,New Jersey Rockets,EHL,34,7,19,26,52,
Marc Del Gaizo,2015-16,Muskegon Lumberjacks,USHL,2,0,0,0,0,-2
Marc Del Gaizo,2016-17,Muskegon Lumberjacks,USHL,58,3,20,23,51,5
Marc Del Gaizo,2017-18,Muskegon Lumberjacks,USHL,59,12,26,38,69,5
Marc Del Gaizo,2018-19,UMass-Amherst,H-East,41,13,16,29,26,31
Marc Del Gaizo,2019-20,UMass-Amherst,H-East,22,4,11,15,14,9
Marc Del Gaizo,2020-21,UMass-Amherst,H-East,27,3,11,14,4,21
Marc Del Gaizo,2020-21,Chicago Wolves,AHL,9,0,5,5,0,3
Marc Del Gaizo,2021-22,Milwaukee Admirals,AHL,67,6,13,19,28,-8
Marc Del Gaizo,2022-23,Milwaukee Admirals,AHL,71,3,28,31,50,-3
Marc Del Gaizo,2023-24,Nashville Predators,NHL,9,0,3,3,2,2
Marc Del Gaizo,2023-24,Milwaukee Admirals,AHL,60,8,26,34,34,18
Marc Del Gaizo,2024-25,Nashville Predators*,NHL,21,0,3,3,17,0
Marc Del Gaizo,2024-25,Milwaukee Admirals,AHL,28,7,4,11,16,8
Rasmus Ristolainen,2010-11,TPS Turku,SM-liiga,1,0,0,0,0,0
Rasmus Ristolainen,2011-12,TPS Turku,SM-liiga,40,3,5,8,78,-21
Rasmus Ristolainen,2012-13,TPS Turku,SM-liiga,52,3,12,15,32,-7
Rasmus Ristolainen,2013-14,Buffalo Sabres,NHL,34,2,2,4,6,-15
Rasmus Ristolainen,2013-14,Rochester Americans,AHL,34,6,14,20,22,-2
Rasmus Ristolainen,2014-15,Buffalo Sabres,NHL,78,8,12,20,26,-32
Rasmus Ristolainen,2015-16,Buffalo Sabres,NHL,82,9,32,41,33,-21
Rasmus Ristolainen,2016-17,Buffalo Sabres,NHL,79,6,39,45,58,-9
Rasmus Ristolainen,2017-18,Buffalo Sabres,NHL,73,6,35,41,48,-25
Rasmus Ristolainen,2018-19,Buffalo Sabres,NHL,78,5,38,43,38,-41
Rasmus Ristolainen,2019-20,Buffalo Sabres,NHL,69,6,27,33,46,-2
Rasmus Ristolainen,2020-21,Buffalo Sabres,NHL,49,4,14,18,36,-18
Rasmus Ristolainen,2021-22,Philadelphia Flyers,NHL,66,2,14,16,38,-9
Rasmus Ristolainen,2022-23,Philadelphia Flyers,NHL,74,3,17,20,32,-4
Rasmus Ristolainen,2023-24,Philadelphia Flyers,NHL,31,1,3,4,8,-6
Rasmus Ristolainen,2024-25,Philadelphia Flyers,NHL,55,3,14,17,12,4
